transaction_id,entity,tr_type,txn_amount,txn_posted_timestamp,account_id,counter_party,balance_after_posted,sender_country,receiver_country,txn_eff_date
1466,HighMark LLC,CREDIT,3570.15,2017-02-10,1,Osvaldo Porter,65094.15,Finland,New York,2017-02-11
1467,HighMark LLC,CREDIT,692.51,2017-02-10,1,Laura Brant,65786.66,Iowa,New York,2017-02-11
1468,HighMark LLC,CREDIT,300.31,2017-02-10,1,Malka Cartwright,66086.97,Alabama,New York,2017-02-11
1469,HighMark LLC,CREDIT,1419.03,2017-02-10,1,Angela Harris,67506.0,Tennessee,New York,2017-02-11
1470,HighMark LLC,CREDIT,405.12,2017-02-10,1,Sandra Blair,67911.12,North Dakota,New York,2017-02-11
1471,HighMark LLC,CREDIT,954.36,2017-02-10,1,Anthony Smith,68865.48,Ireland,New York,2017-02-11
1472,HighMark LLC,CREDIT,1573.52,2017-02-10,1,Lucius Majure,70439.0,Wyoming,New York,2017-02-11
8,HighMark LLC,DEBIT,1969.04,2017-02-10,1,Amanda Alvarado,68469.96,New York,Tennessee,2017-02-11
9,HighMark LLC,DEBIT,2304.22,2017-02-10,1,David Duncan,66165.74,New York,Oregon,2017-02-11
1473,HighMark LLC,CREDIT,400.3,2017-02-10,1,Jason Alves,66566.04000000001,Wyoming,New York,2017-02-11
1474,HighMark LLC,CREDIT,2231.81,2017-02-10,1,Bryan Mui,68797.85,Hawaii,New York,2017-02-11
1475,HighMark LLC,CREDIT,1072.36,2017-02-10,1,Christin Walker,69870.21,Arizona,New York,2017-02-11
1476,HighMark LLC,CREDIT,1384.9,2017-02-10,1,Barbara Hazelrigg,71255.11,Romania,New York,2017-02-11
1477,HighMark LLC,CREDIT,588.0,2017-02-10,1,Amy Garland,71843.11,Slovenia,New York,2017-02-11
1478,HighMark LLC,CREDIT,527.08,2017-02-10,1,Louis Nguyen,72370.19,Hungary,New York,2017-02-11
1479,HighMark LLC,CREDIT,1006.67,2017-02-10,1,Susan Ware,73376.86,New York,New York,2017-02-11
1480,HighMark LLC,CREDIT,2090.21,2017-02-11,1,Catherine Kleine,75467.07,Maryland,New York,2017-02-12
1481,HighMark LLC,CREDIT,2728.15,2017-02-11,1,Victoria Laramie,78195.22,Nebraska,New York,2017-02-12
1482,HighMark LLC,CREDIT,544.52,2017-02-11,1,Maricruz Culver,78739.74,Maine,New York,2017-02-12
1483,HighMark LLC,CREDIT,1119.2,2017-02-12,1,Robert Dugger,79858.94,Slovenia,New York,2017-02-13
1484,HighMark LLC,CREDIT,5386.56,2017-02-12,1,Georgeanna Debem,85245.5,Iowa,New York,2017-02-13
1485,HighMark LLC,CREDIT,1347.22,2017-02-12,1,Sandra Blair,86592.72,North Dakota,New York,2017-02-13
23,HighMark LLC,DEBIT,3358.76,2017-02-12,1,Penelope Price,83233.96,New York,Texas,2017-02-13
1486,HighMark LLC,CREDIT,3783.62,2017-02-12,1,Edna Niese,87017.58,Virginia,New York,2017-02-13
1487,HighMark LLC,CREDIT,698.19,2017-02-12,1,Randi Folger,87715.77,Maryland,New York,2017-02-13
1488,HighMark LLC,CREDIT,834.61,2017-02-12,1,Susie Major,88550.38,Kansas,New York,2017-02-13
1489,HighMark LLC,CREDIT,319.5,2017-02-12,1,Edwin Highshaw,88869.88,Texas,New York,2017-02-13
1490,HighMark LLC,CREDIT,817.26,2017-02-12,1,Danny Singh,89687.14,Oklahoma,New York,2017-02-13
1491,HighMark LLC,CREDIT,5021.76,2017-02-12,1,Warren Nobles,94708.9,Idaho,New York,2017-02-13
1492,HighMark LLC,CREDIT,1448.63,2017-02-13,1,Anthony Smith,96157.53,Ireland,New York,2017-02-14
1493,HighMark LLC,CREDIT,2213.79,2017-02-13,1,Christin Walker,98371.31999999999,Arizona,New York,2017-02-14
1494,HighMark LLC,CREDIT,2905.75,2017-02-13,1,Daniel Walker,101277.06999999999,South Carolina,New York,2017-02-14
1495,HighMark LLC,CREDIT,1425.7,2017-02-13,1,Nancy Stutes,102702.76999999999,Nebraska,New York,2017-02-14
1496,HighMark LLC,CREDIT,1911.09,2017-02-13,1,Linda Henderson,104613.85999999999,Italy,New York,2017-02-14
1497,HighMark LLC,CREDIT,835.26,2017-02-13,1,Georgeanna Debem,105449.11999999998,Iowa,New York,2017-02-14
1498,HighMark LLC,CREDIT,265.6,2017-02-13,1,Vanessa Carter,105714.71999999999,Spain,New York,2017-02-14
1499,HighMark LLC,CREDIT,512.45,2017-02-13,1,Connie Posey,106227.16999999998,Wisconsin,New York,2017-02-14
1500,HighMark LLC,CREDIT,391.81,2017-02-13,1,Glenda Coots,106618.97999999998,Lithuania,New York,2017-02-14
1501,HighMark LLC,CREDIT,729.33,2017-02-13,1,James Cole,107348.30999999998,Wyoming,New York,2017-02-14
1502,HighMark LLC,CREDIT,1192.7,2017-02-13,1,John Nguyen,108541.00999999998,Alaska,New York,2017-02-14
1503,HighMark LLC,CREDIT,2365.82,2017-02-13,1,Samuel Carswell,110906.82999999999,Arkansas,New York,2017-02-14
1504,HighMark LLC,CREDIT,1808.21,2017-02-13,1,Bryan Mui,112715.04,Hawaii,New York,2017-02-14
1505,HighMark LLC,CREDIT,1036.06,2017-02-14,1,Gabriela Hardaway,113751.09999999999,Italy,New York,2017-02-15
1506,HighMark LLC,CREDIT,2684.95,2017-02-14,1,Anthony Barnes,116436.04999999999,Connecticut,New York,2017-02-15
45,HighMark LLC,DEBIT,1875.68,2017-02-14,1,Craig Bailey,114560.37,New York,Croatia,2017-02-15
46,HighMark LLC,DEBIT,6532.31,2017-02-14,1,Christina Creed,108028.06,New York,Mississippi,2017-02-15
1507,HighMark LLC,CREDIT,1899.11,2017-02-14,1,John Ackerman,109927.17,Montana,New York,2017-02-15
1508,HighMark LLC,CREDIT,1476.92,2017-02-14,1,Sandy Newkirk,111404.09,Czech Republic,New York,2017-02-15
1509,HighMark LLC,CREDIT,2486.5,2017-02-14,1,Loren Burgess,113890.59,Alabama,New York,2017-02-15
1510,HighMark LLC,CREDIT,1865.41,2017-02-14,1,Sofia Pinkerton,115756.0,Arkansas,New York,2017-02-15
1511,HighMark LLC,CREDIT,2471.03,2017-02-14,1,Willie Robinson,118227.03,South Dakota,New York,2017-02-15
1512,HighMark LLC,CREDIT,850.38,2017-02-14,1,John Hill,119077.41,Pennsylvania,New York,2017-02-15
1513,HighMark LLC,CREDIT,1328.27,2017-02-14,1,Matthew Ciotti,120405.68000000001,Hawaii,New York,2017-02-15
1514,HighMark LLC,CREDIT,699.55,2017-02-15,1,Antonette Grace,121105.23000000001,United Kingdom,New York,2017-02-16
1515,HighMark LLC,CREDIT,505.75,2017-02-15,1,Barbara Hazelrigg,121610.98000000001,Romania,New York,2017-02-16
1516,HighMark LLC,CREDIT,1809.01,2017-02-15,1,Brad Rose,123419.99,Rhode Island,New York,2017-02-16
1517,HighMark LLC,CREDIT,458.68,2017-02-15,1,Jose Chaves,123878.67,New Jersey,New York,2017-02-16
1518,HighMark LLC,CREDIT,3920.48,2017-02-15,1,Vanessa Carter,127799.15,Spain,New York,2017-02-16
59,HighMark LLC,DEBIT,8929.57,2017-02-15,1,Kenneth Hopkins,118869.57999999999,New York,India,2017-02-16
1519,HighMark LLC,CREDIT,1217.7,2017-02-15,1,Loren Burgess,120087.27999999998,Alabama,New York,2017-02-16
1520,HighMark LLC,CREDIT,1357.42,2017-02-15,1,Linda Henderson,121444.69999999998,Italy,New York,2017-02-16
1521,HighMark LLC,CREDIT,1123.85,2017-02-15,1,Edwin Highshaw,122568.54999999999,Texas,New York,2017-02-16
1522,HighMark LLC,CREDIT,836.84,2017-02-15,1,Gabriela Hardaway,123405.38999999998,Italy,New York,2017-02-16
1523,HighMark LLC,CREDIT,2470.09,2017-02-15,1,Juanita Nichell,125875.47999999998,Indiana,New York,2017-02-16
1524,HighMark LLC,CREDIT,430.87,2017-02-16,1,Loren Burgess,126306.34999999998,Alabama,New York,2017-02-17
1525,HighMark LLC,CREDIT,355.83,2017-02-16,1,Paul Green,126662.17999999998,Portugal,New York,2017-02-17
1526,HighMark LLC,CREDIT,2160.7,2017-02-16,1,Katie Spooner,128822.87999999998,New Mexico,New York,2017-02-17
1527,HighMark LLC,CREDIT,644.75,2017-02-16,1,Gerald Marchant,129467.62999999998,Idaho,New York,2017-02-17
1528,HighMark LLC,CREDIT,1915.54,2017-02-16,1,Kathryn Carter,131383.16999999998,Hawaii,New York,2017-02-17
1529,HighMark LLC,CREDIT,2559.85,2017-02-16,1,Anthony Smith,133943.02,Ireland,New York,2017-02-17
1530,HighMark LLC,CREDIT,378.98,2017-02-17,1,Bill Wagner,134322.0,Portugal,New York,2017-02-18
1531,HighMark LLC,CREDIT,791.19,2017-02-17,1,Sandra Blair,135113.19,North Dakota,New York,2017-02-18
1532,HighMark LLC,CREDIT,1767.97,2017-02-17,1,Joanne Fortin,136881.16,South Carolina,New York,2017-02-18
1533,HighMark LLC,CREDIT,1728.32,2017-02-17,1,Connie Posey,138609.48,Wisconsin,New York,2017-02-18
1534,HighMark LLC,CREDIT,2306.4,2017-02-17,1,Kathryn Carter,140915.88,Hawaii,New York,2017-02-18
76,HighMark LLC,DEBIT,6120.59,2017-02-17,1,Kenneth Hopkins,134795.29,New York,India,2017-02-18
1535,HighMark LLC,CREDIT,3295.02,2017-02-17,1,Brad Rose,138090.31,Rhode Island,New York,2017-02-18
1536,HighMark LLC,CREDIT,1233.08,2017-02-17,1,Malka Cartwright,139323.38999999998,Alabama,New York,2017-02-18
1537,HighMark LLC,CREDIT,252.19,2017-02-17,1,Catherine Kleine,139575.58,Maryland,New York,2017-02-18
1538,HighMark LLC,CREDIT,2287.0,2017-02-17,1,Jennifer Oday,141862.58,North Dakota,New York,2017-02-18
1539,HighMark LLC,CREDIT,982.82,2017-02-18,1,Laura Brant,142845.4,Iowa,New York,2017-02-19
1540,HighMark LLC,CREDIT,622.43,2017-02-18,1,Ronald Mills,143467.83,Netherlands,New York,2017-02-19
1541,HighMark LLC,CREDIT,369.45,2017-02-18,1,Carrie Morrison,143837.28,Belgium,New York,2017-02-19
84,HighMark LLC,DEBIT,4199.3,2017-02-18,1,Helen Melnick,139637.98,New York,Ireland,2017-02-19
85,HighMark LLC,DEBIT,7291.58,2017-02-18,1,Carole Cole,132346.40000000002,New York,Maryland,2017-02-19
1542,HighMark LLC,CREDIT,4607.58,2017-02-18,1,Katie Spooner,136953.98,New Mexico,New York,2017-02-19
1543,HighMark LLC,CREDIT,387.44,2017-02-18,1,Jose Chaves,137341.42,New Jersey,New York,2017-02-19
1544,HighMark LLC,CREDIT,1705.41,2017-02-18,1,Greg Hawkins,139046.83000000002,North Carolina,New York,2017-02-19
1545,HighMark LLC,CREDIT,1821.78,2017-02-18,1,Jason Alves,140868.61000000002,Wyoming,New York,2017-02-19
1546,HighMark LLC,CREDIT,2268.49,2017-02-19,1,Maricruz Culver,143137.1,Maine,New York,2017-02-20
1547,HighMark LLC,CREDIT,715.92,2017-02-19,1,Warren Nobles,143853.02000000002,Idaho,New York,2017-02-20
1548,HighMark LLC,CREDIT,951.93,2017-02-19,1,Ann Rosa,144804.95,Indiana,New York,2017-02-20
93,HighMark LLC,DEBIT,4955.91,2017-02-19,1,Willie Thompson,139849.04,New York,Slovenia,2017-02-20
94,HighMark LLC,DEBIT,3639.81,2017-02-19,1,Teresa Rosa,136209.23,New York,Connecticut,2017-02-20
95,HighMark LLC,DEBIT,2867.29,2017-02-19,1,Grace Krafft,133341.94,New York,North Carolina,2017-02-20
96,HighMark LLC,DEBIT,8678.07,2017-02-19,1,Kenneth Hopkins,124663.87,New York,India,2017-02-20
1549,HighMark LLC,CREDIT,1386.54,2017-02-19,1,Paul Green,126050.40999999999,Portugal,New York,2017-02-20
1550,HighMark LLC,CREDIT,2152.96,2017-02-19,1,Malka Cartwright,128203.37,Alabama,New York,2017-02-20
1551,HighMark LLC,CREDIT,2216.1,2017-02-19,1,Sandy Newkirk,130419.47,Czech Republic,New York,2017-02-20
1552,HighMark LLC,CREDIT,748.41,2017-02-19,1,Edna Niese,131167.88,Virginia,New York,2017-02-20
1553,HighMark LLC,CREDIT,2062.16,2017-02-19,1,Osvaldo Porter,133230.04,Finland,New York,2017-02-20
1554,HighMark LLC,CREDIT,291.29,2017-02-19,1,Sandra Blair,133521.33000000002,North Dakota,New York,2017-02-20
1555,HighMark LLC,CREDIT,1076.0,2017-02-19,1,Angela Harris,134597.33000000002,Tennessee,New York,2017-02-20
1556,HighMark LLC,CREDIT,1038.47,2017-02-19,1,Brenda Magnuson,135635.80000000002,Austria,New York,2017-02-20
1557,HighMark LLC,CREDIT,1647.26,2017-02-20,1,Mike Pickerel,137283.06000000003,North Dakota,New York,2017-02-21
1558,HighMark LLC,CREDIT,2862.06,2017-02-20,1,John Hill,140145.12000000002,Pennsylvania,New York,2017-02-21
1559,HighMark LLC,CREDIT,2980.38,2017-02-20,1,Lucius Majure,143125.50000000003,Wyoming,New York,2017-02-21
1560,HighMark LLC,CREDIT,4048.88,2017-02-20,1,Connie Posey,147174.38000000003,Wisconsin,New York,2017-02-21
1561,HighMark LLC,CREDIT,2375.77,2017-02-20,1,Brad Rose,149550.15000000002,Rhode Island,New York,2017-02-21
1562,HighMark LLC,CREDIT,1151.96,2017-02-20,1,Herbert Peevey,150702.11000000002,Sweden,New York,2017-02-21
1563,HighMark LLC,CREDIT,1202.42,2017-02-20,1,Laura Brant,151904.53000000003,Iowa,New York,2017-02-21
1564,HighMark LLC,CREDIT,1475.47,2017-02-20,1,John Nguyen,153380.00000000003,Alaska,New York,2017-02-21
1565,HighMark LLC,CREDIT,1191.39,2017-02-20,1,Gabriela Hardaway,154571.39000000004,Italy,New York,2017-02-21
1566,HighMark LLC,CREDIT,5324.1,2017-02-20,1,Bryan Mui,159895.49000000005,Hawaii,New York,2017-02-21
1567,HighMark LLC,CREDIT,2026.0,2017-02-21,1,Gerald Marchant,161921.49000000005,Idaho,New York,2017-02-22
1568,HighMark LLC,CREDIT,1466.56,2017-02-21,1,Edna Jones,163388.05000000005,Latvia,New York,2017-02-22
1569,HighMark LLC,CREDIT,797.12,2017-02-21,1,James Cole,164185.17000000004,Wyoming,New York,2017-02-22
1570,HighMark LLC,CREDIT,3761.58,2017-02-21,1,Jose Chaves,167946.75000000003,New Jersey,New York,2017-02-22
119,HighMark LLC,DEBIT,1866.45,2017-02-21,1,Ronnie Stone,166080.30000000002,New York,Maine,2017-02-22
1571,HighMark LLC,CREDIT,734.64,2017-02-21,1,William Stone,166814.94000000003,Bulgaria,New York,2017-02-22
1572,HighMark LLC,CREDIT,339.51,2017-02-21,1,Cheryl Trilli,167154.45000000004,Oregon,New York,2017-02-22
1573,HighMark LLC,CREDIT,552.69,2017-02-21,1,Mike Pickerel,167707.14000000004,North Dakota,New York,2017-02-22
1574,HighMark LLC,CREDIT,3016.72,2017-02-21,1,Katie Spooner,170723.86000000004,New Mexico,New York,2017-02-22
1575,HighMark LLC,CREDIT,1256.11,2017-02-22,1,Greg Hawkins,171979.97000000003,North Carolina,New York,2017-02-23
1576,HighMark LLC,CREDIT,358.09,2017-02-22,1,Gerald Marchant,172338.06000000003,Idaho,New York,2017-02-23
126,HighMark LLC,DEBIT,1721.22,2017-02-22,1,Amanda Alvarado,170616.84000000003,New York,Tennessee,2017-02-23
1577,HighMark LLC,CREDIT,430.43,2017-02-22,1,Michael Rice,171047.27000000002,Rhode Island,New York,2017-02-23
1578,HighMark LLC,CREDIT,2628.52,2017-02-22,1,Jennifer Perez,173675.79,France,New York,2017-02-23
1579,HighMark LLC,CREDIT,1289.6,2017-02-22,1,Mike Pickerel,174965.39,North Dakota,New York,2017-02-23
1580,HighMark LLC,CREDIT,1916.73,2017-02-22,1,Ronald Mills,176882.12000000002,Netherlands,New York,2017-02-23
1581,HighMark LLC,CREDIT,2027.53,2017-02-22,1,Amy Garland,178909.65000000002,Slovenia,New York,2017-02-23
1582,HighMark LLC,CREDIT,1042.06,2017-02-22,1,Susan Ware,179951.71000000002,New York,New York,2017-02-23
133,HighMark LLC,DEBIT,1982.9,2017-02-23,1,Christina Creed,177968.81000000003,New York,Mississippi,2017-02-24
1583,HighMark LLC,CREDIT,1083.15,2017-02-23,1,Jason Alves,179051.96000000002,Wyoming,New York,2017-02-24
1584,HighMark LLC,CREDIT,1071.82,2017-02-23,1,Tammy Orozco,180123.78000000003,Montana,New York,2017-02-24
1585,HighMark LLC,CREDIT,5179.05,2017-02-23,1,Anthony Barnes,185302.83000000002,Connecticut,New York,2017-02-24
1586,HighMark LLC,CREDIT,524.58,2017-02-23,1,James Gadbois,185827.41,Maryland,New York,2017-02-24
1587,HighMark LLC,CREDIT,2208.43,2017-02-23,1,Sofia Pinkerton,188035.84,Arkansas,New York,2017-02-24
1588,HighMark LLC,CREDIT,513.2,2017-02-23,1,Antonette Grace,188549.04,United Kingdom,New York,2017-02-24
1589,HighMark LLC,CREDIT,386.12,2017-02-23,1,Stan Tannenbaum,188935.16,Rhode Island,New York,2017-02-24
1590,HighMark LLC,CREDIT,1787.49,2017-02-24,1,Tammy Orozco,190722.65,Montana,New York,2017-02-25
1591,HighMark LLC,CREDIT,1830.65,2017-02-24,1,Vanessa Carter,192553.3,Spain,New York,2017-02-25
1592,HighMark LLC,CREDIT,1346.82,2017-02-24,1,Stan Tannenbaum,193900.12,Rhode Island,New York,2017-02-25
1593,HighMark LLC,CREDIT,575.91,2017-02-24,1,Matthew Ciotti,194476.03,Hawaii,New York,2017-02-25
1594,HighMark LLC,CREDIT,1738.44,2017-02-24,1,Juanita Nichell,196214.47,Indiana,New York,2017-02-25
1595,HighMark LLC,CREDIT,378.9,2017-02-24,1,Victoria Laramie,196593.37,Nebraska,New York,2017-02-25
1596,HighMark LLC,CREDIT,662.39,2017-02-24,1,Julio Mccabe,197255.76,Wisconsin,New York,2017-02-25
1597,HighMark LLC,CREDIT,3230.89,2017-02-24,1,Anthony Barnes,200486.65000000002,Connecticut,New York,2017-02-25
1598,HighMark LLC,CREDIT,1377.67,2017-02-24,1,Edwin Highshaw,201864.32000000004,Texas,New York,2017-02-25
150,HighMark LLC,DEBIT,4127.15,2017-02-24,1,Gwendolyn Morrison,197737.17000000004,New York,Maryland,2017-02-25
1599,HighMark LLC,CREDIT,4657.26,2017-02-25,1,Barbara Bale,202394.43000000005,Michigan,New York,2017-02-26
1600,HighMark LLC,CREDIT,794.53,2017-02-25,1,Mike Pickerel,203188.96000000005,North Dakota,New York,2017-02-26
1601,HighMark LLC,CREDIT,264.17,2017-02-25,1,Katie Spooner,203453.13000000006,New Mexico,New York,2017-02-26
154,HighMark LLC,DEBIT,3627.12,2017-02-25,1,Johnnie Lepage,199826.01000000007,New York,Connecticut,2017-02-26
1602,HighMark LLC,CREDIT,3023.27,2017-02-26,1,Juanita Nichell,202849.28000000006,Indiana,New York,2017-02-27
1603,HighMark LLC,CREDIT,1096.78,2017-02-26,1,Anthony Barnes,203946.06000000006,Connecticut,New York,2017-02-27
1604,HighMark LLC,CREDIT,1515.8,2017-02-26,1,Bill Wagner,205461.86000000004,Portugal,New York,2017-02-27
1605,HighMark LLC,CREDIT,784.02,2017-02-26,1,Darius Sherrill,206245.88000000003,Arkansas,New York,2017-02-27
1606,HighMark LLC,CREDIT,480.73,2017-02-26,1,Mike Pickerel,206726.61000000004,North Dakota,New York,2017-02-27
1607,HighMark LLC,CREDIT,547.66,2017-02-26,1,Sandra Blair,207274.27000000005,North Dakota,New York,2017-02-27
1608,HighMark LLC,CREDIT,1011.34,2017-02-26,1,Jennifer Oday,208285.61000000004,North Dakota,New York,2017-02-27
1609,HighMark LLC,CREDIT,3349.76,2017-02-26,1,Edna Niese,211635.37000000005,Virginia,New York,2017-02-27
1610,HighMark LLC,CREDIT,1702.22,2017-02-27,1,Jason Alves,213337.59000000005,Wyoming,New York,2017-02-28
1611,HighMark LLC,CREDIT,2778.12,2017-02-27,1,Mae Gregory,216115.71000000005,Portugal,New York,2017-02-28
1612,HighMark LLC,CREDIT,455.02,2017-02-27,1,Bryan Mui,216570.73000000004,Hawaii,New York,2017-02-28
1613,HighMark LLC,CREDIT,2734.71,2017-02-27,1,Glenda Coots,219305.44000000003,Lithuania,New York,2017-02-28
1614,HighMark LLC,CREDIT,1043.37,2017-02-27,1,Antonette Grace,220348.81000000003,United Kingdom,New York,2017-02-28
1615,HighMark LLC,CREDIT,855.14,2017-02-28,1,Warren Nobles,221203.95000000004,Idaho,New York,2017-03-01
1616,HighMark LLC,CREDIT,844.09,2017-02-28,1,Samuel Carswell,222048.04000000004,Arkansas,New York,2017-03-01
1617,HighMark LLC,CREDIT,2913.2,2017-02-28,1,Gerald Marchant,224961.24000000005,Idaho,New York,2017-03-01
1618,HighMark LLC,CREDIT,4031.84,2017-02-28,1,Louis Nguyen,228993.08000000005,Hungary,New York,2017-03-01
1619,HighMark LLC,CREDIT,3192.17,2017-02-28,1,Victoria Laramie,232185.25000000006,Nebraska,New York,2017-03-01
1620,HighMark LLC,CREDIT,883.64,2017-02-28,1,Lucius Majure,233068.89000000007,Wyoming,New York,2017-03-01
1621,HighMark LLC,CREDIT,457.68,2017-02-28,1,Lois Collier,233526.57000000007,Estonia,New York,2017-03-01
1622,HighMark LLC,CREDIT,2220.72,2017-02-28,1,Malka Cartwright,235747.29000000007,Alabama,New York,2017-03-01
1623,HighMark LLC,CREDIT,347.03,2017-02-28,1,William Stone,236094.32000000007,Bulgaria,New York,2017-03-01
1624,HighMark LLC,CREDIT,936.49,2017-02-28,1,Mike Pickerel,237030.81000000006,North Dakota,New York,2017-03-01
1625,HighMark LLC,CREDIT,1431.21,2017-02-28,1,Bryan Mui,238462.02000000005,Hawaii,New York,2017-03-01
1626,HighMark LLC,CREDIT,1662.43,2017-03-01,1,Maricruz Culver,240124.45000000004,Maine,New York,2017-03-02
1627,HighMark LLC,CREDIT,597.99,2017-03-01,1,Bryan Mui,240722.44000000003,Hawaii,New York,2017-03-02
1628,HighMark LLC,CREDIT,2489.96,2017-03-01,1,Edwin Highshaw,243212.40000000002,Texas,New York,2017-03-02
1629,HighMark LLC,CREDIT,1088.97,2017-03-01,1,Malka Cartwright,244301.37000000002,Alabama,New York,2017-03-02
1630,HighMark LLC,CREDIT,312.94,2017-03-01,1,Brenda Magnuson,244614.31000000003,Austria,New York,2017-03-02
1631,HighMark LLC,CREDIT,2777.91,2017-03-01,1,Loren Burgess,247392.22000000003,Alabama,New York,2017-03-02
1632,HighMark LLC,CREDIT,2303.47,2017-03-01,1,Mark Alexander,249695.69000000003,Pennsylvania,New York,2017-03-02
1633,HighMark LLC,CREDIT,1443.69,2017-03-01,1,Susan Ware,251139.38000000003,New York,New York,2017-03-02
187,HighMark LLC,DEBIT,3650.25,2017-03-02,1,Martha Switzer,247489.13000000003,New York,Montana,2017-03-03
1634,HighMark LLC,CREDIT,1420.43,2017-03-02,1,Katie Spooner,248909.56000000003,New Mexico,New York,2017-03-03
1635,HighMark LLC,CREDIT,1401.49,2017-03-02,1,Louis Nguyen,250311.05000000002,Hungary,New York,2017-03-03
1636,HighMark LLC,CREDIT,680.69,2017-03-02,1,Scott Anzalone,250991.74000000002,New York,New York,2017-03-03
1637,HighMark LLC,CREDIT,2771.95,2017-03-02,1,Barbara Bale,253763.69000000003,Michigan,New York,2017-03-03
1638,HighMark LLC,CREDIT,538.51,2017-03-02,1,John Hill,254302.20000000004,Pennsylvania,New York,2017-03-03
1639,HighMark LLC,CREDIT,622.76,2017-03-02,1,Barbara Hazelrigg,254924.96000000005,Romania,New York,2017-03-03
1640,HighMark LLC,CREDIT,404.28,2017-03-03,1,Linda Henderson,255329.24000000005,Italy,New York,2017-03-04
1641,HighMark LLC,CREDIT,903.85,2017-03-03,1,John Hill,256233.09000000005,Pennsylvania,New York,2017-03-04
1642,HighMark LLC,CREDIT,2377.54,2017-03-03,1,Anthony Barnes,258610.63000000006,Connecticut,New York,2017-03-04
1643,HighMark LLC,CREDIT,3077.53,2017-03-03,1,Loren Burgess,261688.16000000006,Alabama,New York,2017-03-04
198,HighMark LLC,DEBIT,6330.23,2017-03-03,1,Quincy Adamczak,255357.93000000005,New York,New Hampshire,2017-03-04
199,HighMark LLC,DEBIT,2661.23,2017-03-03,1,Dennis Turton,252696.70000000004,New York,Austria,2017-03-04
200,HighMark LLC,DEBIT,5013.19,2017-03-03,1,Stephanie Snook,247683.51000000004,New York,Delaware,2017-03-04
1644,HighMark LLC,CREDIT,252.52,2017-03-03,1,James Gadbois,247936.03000000003,Maryland,New York,2017-03-04
1645,HighMark LLC,CREDIT,537.55,2017-03-04,1,Georgeanna Debem,248473.58000000002,Iowa,New York,2017-03-05
1646,HighMark LLC,CREDIT,552.48,2017-03-04,1,Danny Singh,249026.06000000003,Oklahoma,New York,2017-03-05
1647,HighMark LLC,CREDIT,392.18,2017-03-04,1,William Stone,249418.24000000002,Bulgaria,New York,2017-03-05
1648,HighMark LLC,CREDIT,974.13,2017-03-04,1,Loren Burgess,250392.37000000002,Alabama,New York,2017-03-05
1649,HighMark LLC,CREDIT,1001.85,2017-03-04,1,Lois Snyder,251394.22000000003,Illinois,New York,2017-03-05
1650,HighMark LLC,CREDIT,1096.29,2017-03-04,1,William Deleon,252490.51000000004,Mississippi,New York,2017-03-05
1651,HighMark LLC,CREDIT,2869.44,2017-03-05,1,James Cole,255359.95000000004,Wyoming,New York,2017-03-06
1652,HighMark LLC,CREDIT,276.74,2017-03-05,1,Cheryl Trilli,255636.69000000003,Oregon,New York,2017-03-06
1653,HighMark LLC,CREDIT,1898.41,2017-03-05,1,Anthony Barnes,257535.10000000003,Connecticut,New York,2017-03-06
1654,HighMark LLC,CREDIT,2770.93,2017-03-05,1,Malka Cartwright,260306.03000000003,Alabama,New York,2017-03-06
1655,HighMark LLC,CREDIT,2800.02,2017-03-05,1,Catherine Kleine,263106.05000000005,Maryland,New York,2017-03-06
1656,HighMark LLC,CREDIT,1279.68,2017-03-05,1,Susie Major,264385.73000000004,Kansas,New York,2017-03-06
1657,HighMark LLC,CREDIT,1941.17,2017-03-05,1,John Nguyen,266326.9,Alaska,New York,2017-03-06
1658,HighMark LLC,CREDIT,5832.98,2017-03-05,1,Willie Robinson,272159.88,South Dakota,New York,2017-03-06
1659,HighMark LLC,CREDIT,2218.79,2017-03-05,1,Samuel Carswell,274378.67,Arkansas,New York,2017-03-06
217,HighMark LLC,DEBIT,3661.92,2017-03-05,1,Juanita Caffey,270716.75,New York,Romania,2017-03-06
1660,HighMark LLC,CREDIT,1362.22,2017-03-05,1,Connie Posey,272078.97,Wisconsin,New York,2017-03-06
1661,HighMark LLC,CREDIT,1585.89,2017-03-05,1,John Hill,273664.86,Pennsylvania,New York,2017-03-06
1662,HighMark LLC,CREDIT,270.63,2017-03-06,1,Catherine Kleine,273935.49,Maryland,New York,2017-03-07
1663,HighMark LLC,CREDIT,724.26,2017-03-06,1,Thomas Jones,274659.75,Slovenia,New York,2017-03-07
1664,HighMark LLC,CREDIT,776.42,2017-03-06,1,Barbara Bale,275436.17,Michigan,New York,2017-03-07
1665,HighMark LLC,CREDIT,1052.51,2017-03-06,1,Cheryl Trilli,276488.68,Oregon,New York,2017-03-07
1666,HighMark LLC,CREDIT,2197.42,2017-03-06,1,Sandy Newkirk,278686.1,Czech Republic,New York,2017-03-07
1667,HighMark LLC,CREDIT,336.33,2017-03-06,1,Jennifer Perez,279022.43,France,New York,2017-03-07
1668,HighMark LLC,CREDIT,2778.77,2017-03-06,1,Warren Nobles,281801.2,Idaho,New York,2017-03-07
1669,HighMark LLC,CREDIT,3725.25,2017-03-07,1,Ronald Mills,285526.45,Netherlands,New York,2017-03-08
1670,HighMark LLC,CREDIT,280.32,2017-03-07,1,John Ackerman,285806.77,Montana,New York,2017-03-08
1671,HighMark LLC,CREDIT,1496.21,2017-03-07,1,Glenda Coots,287302.98000000004,Lithuania,New York,2017-03-08
1672,HighMark LLC,CREDIT,290.35,2017-03-07,1,Antonette Grace,287593.33,United Kingdom,New York,2017-03-08
1673,HighMark LLC,CREDIT,1668.04,2017-03-07,1,Barbara Hazelrigg,289261.37,Romania,New York,2017-03-08
1674,HighMark LLC,CREDIT,1817.19,2017-03-07,1,Jose Chaves,291078.56,New Jersey,New York,2017-03-08
1675,HighMark LLC,CREDIT,338.23,2017-03-08,1,Osvaldo Porter,291416.79,Finland,New York,2017-03-09
234,HighMark LLC,DEBIT,3248.59,2017-03-08,1,Juanita Caffey,288168.19999999995,New York,Romania,2017-03-09
1676,HighMark LLC,CREDIT,1670.36,2017-03-08,1,Aaron Parker,289838.55999999994,Alabama,New York,2017-03-09
1677,HighMark LLC,CREDIT,1181.88,2017-03-08,1,Barbara Hazelrigg,291020.43999999994,Romania,New York,2017-03-09
1678,HighMark LLC,CREDIT,2724.98,2017-03-08,1,Barbara Bale,293745.4199999999,Michigan,New York,2017-03-09
1679,HighMark LLC,CREDIT,582.45,2017-03-08,1,William Deleon,294327.86999999994,Mississippi,New York,2017-03-09
1680,HighMark LLC,CREDIT,409.46,2017-03-09,1,Frank Tafel,294737.32999999996,Finland,New York,2017-03-10
1681,HighMark LLC,CREDIT,2024.42,2017-03-09,1,Sarah Yates,296761.74999999994,Georgia,New York,2017-03-10
1682,HighMark LLC,CREDIT,797.75,2017-03-09,1,Angela Harris,297559.49999999994,Tennessee,New York,2017-03-10
1683,HighMark LLC,CREDIT,2485.81,2017-03-09,1,Winford Landry,300045.30999999994,Maine,New York,2017-03-10
1684,HighMark LLC,CREDIT,931.92,2017-03-09,1,Danny Singh,300977.2299999999,Oklahoma,New York,2017-03-10
1685,HighMark LLC,CREDIT,2307.68,2017-03-09,1,Darius Sherrill,303284.9099999999,Arkansas,New York,2017-03-10
1686,HighMark LLC,CREDIT,603.81,2017-03-10,1,Daniel Villeneuve,303888.7199999999,South Dakota,New York,2017-03-11
1687,HighMark LLC,CREDIT,2696.88,2017-03-10,1,Paul Green,306585.5999999999,Portugal,New York,2017-03-11
1688,HighMark LLC,CREDIT,458.97,2017-03-10,1,Ruby Sneeden,307044.5699999999,Idaho,New York,2017-03-11
1689,HighMark LLC,CREDIT,1037.02,2017-03-11,1,Mark Alexander,308081.5899999999,Pennsylvania,New York,2017-03-12
1690,HighMark LLC,CREDIT,4506.96,2017-03-11,1,Danny Singh,312588.54999999993,Oklahoma,New York,2017-03-12
1691,HighMark LLC,CREDIT,689.71,2017-03-11,1,Darius Sherrill,313278.25999999995,Arkansas,New York,2017-03-12
1692,HighMark LLC,CREDIT,1718.39,2017-03-11,1,Edna Jones,314996.64999999997,Latvia,New York,2017-03-12
1693,HighMark LLC,CREDIT,1406.28,2017-03-11,1,Leon Birchler,316402.93,Bulgaria,New York,2017-03-12
1694,HighMark LLC,CREDIT,437.64,2017-03-11,1,Christin Walker,316840.57,Arizona,New York,2017-03-12
1695,HighMark LLC,CREDIT,2219.52,2017-03-12,1,Cheryl Trilli,319060.09,Oregon,New York,2017-03-13
1696,HighMark LLC,CREDIT,957.37,2017-03-12,1,Brad Rose,320017.46,Rhode Island,New York,2017-03-13
1697,HighMark LLC,CREDIT,732.14,2017-03-12,1,Connie Posey,320749.60000000003,Wisconsin,New York,2017-03-13
1698,HighMark LLC,CREDIT,1466.25,2017-03-12,1,Sofia Pinkerton,322215.85000000003,Arkansas,New York,2017-03-13
1699,HighMark LLC,CREDIT,1756.13,2017-03-12,1,Gabriela Hardaway,323971.98000000004,Italy,New York,2017-03-13
1700,HighMark LLC,CREDIT,1962.39,2017-03-12,1,Leon Birchler,325934.37000000005,Bulgaria,New York,2017-03-13
1701,HighMark LLC,CREDIT,1607.96,2017-03-12,1,Susie Major,327542.3300000001,Kansas,New York,2017-03-13
1702,HighMark LLC,CREDIT,741.84,2017-03-12,1,Linda Henderson,328284.1700000001,Italy,New York,2017-03-13
262,HighMark LLC,DEBIT,2430.88,2017-03-12,1,Carole Cole,325853.2900000001,New York,Maryland,2017-03-13
1703,HighMark LLC,CREDIT,3356.85,2017-03-12,1,Mike Pickerel,329210.1400000001,North Dakota,New York,2017-03-13
1704,HighMark LLC,CREDIT,3266.89,2017-03-13,1,Catherine Kleine,332477.0300000001,Maryland,New York,2017-03-14
1705,HighMark LLC,CREDIT,3152.87,2017-03-13,1,Edna Niese,335629.9000000001,Virginia,New York,2017-03-14
1706,HighMark LLC,CREDIT,542.88,2017-03-13,1,Angel Hirsch,336172.7800000001,Pennsylvania,New York,2017-03-14
267,HighMark LLC,DEBIT,6917.57,2017-03-13,1,Dennis Turton,329255.2100000001,New York,Austria,2017-03-14
268,HighMark LLC,DEBIT,3560.56,2017-03-13,1,Megan Inman,325694.6500000001,New York,Slovenia,2017-03-14
1707,HighMark LLC,CREDIT,1199.84,2017-03-13,1,Anthony Barnes,326894.4900000001,Connecticut,New York,2017-03-14
1708,HighMark LLC,CREDIT,4698.91,2017-03-13,1,Tammy Orozco,331593.4000000001,Montana,New York,2017-03-14
1709,HighMark LLC,CREDIT,546.17,2017-03-13,1,Samuel Carswell,332139.57000000007,Arkansas,New York,2017-03-14
1710,HighMark LLC,CREDIT,782.69,2017-03-14,1,Anthony Barnes,332922.26000000007,Connecticut,New York,2017-03-15
1711,HighMark LLC,CREDIT,2196.78,2017-03-14,1,Sarah Yates,335119.0400000001,Georgia,New York,2017-03-15
1712,HighMark LLC,CREDIT,546.49,2017-03-14,1,Glenda Coots,335665.5300000001,Lithuania,New York,2017-03-15
275,HighMark LLC,DEBIT,3530.29,2017-03-14,1,Amber Johnson,332135.2400000001,New York,Illinois,2017-03-15
1713,HighMark LLC,CREDIT,1083.01,2017-03-14,1,Joanne Fortin,333218.2500000001,South Carolina,New York,2017-03-15
1714,HighMark LLC,CREDIT,2807.24,2017-03-14,1,Catherine Kleine,336025.4900000001,Maryland,New York,2017-03-15
1715,HighMark LLC,CREDIT,4732.61,2017-03-14,1,Robert Dugger,340758.1000000001,Slovenia,New York,2017-03-15
1716,HighMark LLC,CREDIT,1981.79,2017-03-14,1,Lois Snyder,342739.8900000001,Illinois,New York,2017-03-15
1717,HighMark LLC,CREDIT,1194.12,2017-03-14,1,Sandy Newkirk,343934.01000000007,Czech Republic,New York,2017-03-15
1718,HighMark LLC,CREDIT,3543.69,2017-03-15,1,Susan Ware,347477.70000000007,New York,New York,2017-03-16
1719,HighMark LLC,CREDIT,1782.54,2017-03-15,1,Anthony Barnes,349260.24000000005,Connecticut,New York,2017-03-16
1720,HighMark LLC,CREDIT,2626.91,2017-03-16,1,Osvaldo Porter,351887.15,Finland,New York,2017-03-17
1721,HighMark LLC,CREDIT,368.9,2017-03-16,1,Michael Rice,352256.05000000005,Rhode Island,New York,2017-03-17
1722,HighMark LLC,CREDIT,1545.28,2017-03-16,1,Jason Alves,353801.3300000001,Wyoming,New York,2017-03-17
1723,HighMark LLC,CREDIT,1307.21,2017-03-16,1,Amy Garland,355108.5400000001,Slovenia,New York,2017-03-17
1724,HighMark LLC,CREDIT,368.38,2017-03-16,1,Edna Jones,355476.9200000001,Latvia,New York,2017-03-17
1725,HighMark LLC,CREDIT,659.41,2017-03-17,1,Susie Major,356136.3300000001,Kansas,New York,2017-03-18
1726,HighMark LLC,CREDIT,616.55,2017-03-17,1,Mike Pickerel,356752.88000000006,North Dakota,New York,2017-03-18
1727,HighMark LLC,CREDIT,1353.87,2017-03-17,1,Michael Rice,358106.75000000006,Rhode Island,New York,2017-03-18
1728,HighMark LLC,CREDIT,1988.09,2017-03-17,1,John Ackerman,360094.8400000001,Montana,New York,2017-03-18
1729,HighMark LLC,CREDIT,4875.57,2017-03-17,1,Willie Robinson,364970.4100000001,South Dakota,New York,2017-03-18
1730,HighMark LLC,CREDIT,3558.09,2017-03-18,1,Brenda Magnuson,368528.5000000001,Austria,New York,2017-03-19
1731,HighMark LLC,CREDIT,642.73,2017-03-18,1,Linda Henderson,369171.2300000001,Italy,New York,2017-03-19
1732,HighMark LLC,CREDIT,472.19,2017-03-18,1,Danny Singh,369643.4200000001,Oklahoma,New York,2017-03-19
1733,HighMark LLC,CREDIT,1126.16,2017-03-18,1,Frank Tafel,370769.5800000001,Finland,New York,2017-03-19
1734,HighMark LLC,CREDIT,851.46,2017-03-18,1,Laura Brant,371621.0400000001,Iowa,New York,2017-03-19
1735,HighMark LLC,CREDIT,2548.59,2017-03-18,1,Angel Hirsch,374169.6300000001,Pennsylvania,New York,2017-03-19
1736,HighMark LLC,CREDIT,305.0,2017-03-19,1,Warren Nobles,374474.6300000001,Idaho,New York,2017-03-20
1737,HighMark LLC,CREDIT,2066.64,2017-03-19,1,Bryan Mui,376541.27000000014,Hawaii,New York,2017-03-20
1738,HighMark LLC,CREDIT,2355.38,2017-03-19,1,Bill Wagner,378896.65000000014,Portugal,New York,2017-03-20
1739,HighMark LLC,CREDIT,959.8,2017-03-19,1,Thomas Jones,379856.4500000001,Slovenia,New York,2017-03-20
1740,HighMark LLC,CREDIT,2024.46,2017-03-19,1,Anthony Barnes,381880.91000000015,Connecticut,New York,2017-03-20
1741,HighMark LLC,CREDIT,405.86,2017-03-19,1,William Stone,382286.77000000014,Bulgaria,New York,2017-03-20
1742,HighMark LLC,CREDIT,736.95,2017-03-20,1,Susan Ware,383023.72000000015,New York,New York,2017-03-21
1743,HighMark LLC,CREDIT,3765.69,2017-03-20,1,Lucius Majure,386789.41000000015,Wyoming,New York,2017-03-21
1744,HighMark LLC,CREDIT,1003.08,2017-03-20,1,Jose Chaves,387792.49000000017,New Jersey,New York,2017-03-21
1745,HighMark LLC,CREDIT,1481.23,2017-03-20,1,Sandy Newkirk,389273.72000000015,Czech Republic,New York,2017-03-21
1746,HighMark LLC,CREDIT,3258.35,2017-03-20,1,Antonette Grace,392532.0700000001,United Kingdom,New York,2017-03-21
1747,HighMark LLC,CREDIT,1559.28,2017-03-20,1,Barbara Hazelrigg,394091.35000000015,Romania,New York,2017-03-21
1748,HighMark LLC,CREDIT,1463.0,2017-03-20,1,Darius Sherrill,395554.35000000015,Arkansas,New York,2017-03-21
1749,HighMark LLC,CREDIT,1665.64,2017-03-20,1,Jennifer Perez,397219.99000000017,France,New York,2017-03-21
1750,HighMark LLC,CREDIT,1912.07,2017-03-20,1,Samuel Carswell,399132.0600000002,Arkansas,New York,2017-03-21
1751,HighMark LLC,CREDIT,2444.44,2017-03-21,1,Osvaldo Porter,401576.5000000002,Finland,New York,2017-03-22
1752,HighMark LLC,CREDIT,1114.16,2017-03-21,1,Casey Huffman,402690.66000000015,Arkansas,New York,2017-03-22
1753,HighMark LLC,CREDIT,1026.16,2017-03-21,1,Anthony Barnes,403716.8200000001,Connecticut,New York,2017-03-22
1754,HighMark LLC,CREDIT,1031.93,2017-03-21,1,Mike Pickerel,404748.7500000001,North Dakota,New York,2017-03-22
1755,HighMark LLC,CREDIT,5555.83,2017-03-21,1,Robert Dugger,410304.58000000013,Slovenia,New York,2017-03-22
1756,HighMark LLC,CREDIT,546.58,2017-03-21,1,Dulce Bustos,410851.16000000015,Slovenia,New York,2017-03-22
1757,HighMark LLC,CREDIT,2242.47,2017-03-21,1,Bill Wagner,413093.6300000001,Portugal,New York,2017-03-22
1758,HighMark LLC,CREDIT,1064.17,2017-03-21,1,Stan Tannenbaum,414157.8000000001,Rhode Island,New York,2017-03-22
1759,HighMark LLC,CREDIT,1919.9,2017-03-21,1,Maricruz Culver,416077.7000000001,Maine,New York,2017-03-22
1760,HighMark LLC,CREDIT,894.12,2017-03-21,1,Connie Posey,416971.8200000001,Wisconsin,New York,2017-03-22
1761,HighMark LLC,CREDIT,3230.99,2017-03-21,1,Loren Burgess,420202.8100000001,Alabama,New York,2017-03-22
1762,HighMark LLC,CREDIT,2730.92,2017-03-22,1,Carrie Morrison,422933.7300000001,Belgium,New York,2017-03-23
1763,HighMark LLC,CREDIT,1854.57,2017-03-22,1,Louis Nguyen,424788.3000000001,Hungary,New York,2017-03-23
1764,HighMark LLC,CREDIT,1872.59,2017-03-22,1,Julio Mccabe,426660.89000000013,Wisconsin,New York,2017-03-23
1765,HighMark LLC,CREDIT,1142.78,2017-03-22,1,William Deleon,427803.67000000016,Mississippi,New York,2017-03-23
1766,HighMark LLC,CREDIT,648.73,2017-03-22,1,Frankie Manners,428452.40000000014,Oregon,New York,2017-03-23
1767,HighMark LLC,CREDIT,2682.48,2017-03-23,1,Osvaldo Porter,431134.8800000001,Finland,New York,2017-03-24
1768,HighMark LLC,CREDIT,2107.19,2017-03-23,1,Gerald Alarcon,433242.0700000001,Belgium,New York,2017-03-24
332,HighMark LLC,DEBIT,11947.57,2017-03-23,1,James Moskal,421294.5000000001,New York,Bulgaria,2017-03-24
333,HighMark LLC,DEBIT,4197.51,2017-03-23,1,Philip Quinonez,417096.9900000001,New York,Tennessee,2017-03-24
1769,HighMark LLC,CREDIT,755.69,2017-03-23,1,Jennifer Perez,417852.6800000001,France,New York,2017-03-24
1770,HighMark LLC,CREDIT,652.58,2017-03-23,1,Brad Rose,418505.2600000001,Rhode Island,New York,2017-03-24
1771,HighMark LLC,CREDIT,2819.46,2017-03-23,1,Angel Hirsch,421324.72000000015,Pennsylvania,New York,2017-03-24
1772,HighMark LLC,CREDIT,2015.02,2017-03-23,1,Anthony Barnes,423339.74000000017,Connecticut,New York,2017-03-24
1773,HighMark LLC,CREDIT,3306.21,2017-03-23,1,Edna Jones,426645.9500000002,Latvia,New York,2017-03-24
1774,HighMark LLC,CREDIT,1639.41,2017-03-23,1,Donald Weber,428285.36000000016,Georgia,New York,2017-03-24
1775,HighMark LLC,CREDIT,321.18,2017-03-23,1,Louis Nguyen,428606.54000000015,Hungary,New York,2017-03-24
1776,HighMark LLC,CREDIT,2939.96,2017-03-23,1,Herbert Peevey,431546.5000000002,Sweden,New York,2017-03-24
1777,HighMark LLC,CREDIT,1119.59,2017-03-24,1,Laura Brant,432666.0900000002,Iowa,New York,2017-03-25
1778,HighMark LLC,CREDIT,1160.01,2017-03-24,1,Bill Wagner,433826.1000000002,Portugal,New York,2017-03-25
1779,HighMark LLC,CREDIT,290.18,2017-03-24,1,Gerald Marchant,434116.2800000002,Idaho,New York,2017-03-25
1780,HighMark LLC,CREDIT,995.08,2017-03-24,1,Victoria Laramie,435111.3600000002,Nebraska,New York,2017-03-25
1781,HighMark LLC,CREDIT,995.76,2017-03-24,1,Casey Huffman,436107.1200000002,Arkansas,New York,2017-03-25
1782,HighMark LLC,CREDIT,2346.79,2017-03-24,1,Lucius Majure,438453.9100000002,Wyoming,New York,2017-03-25
1783,HighMark LLC,CREDIT,4062.95,2017-03-25,1,Edwin Highshaw,442516.8600000002,Texas,New York,2017-03-26
1784,HighMark LLC,CREDIT,1106.87,2017-03-25,1,Victoria Laramie,443623.7300000002,Nebraska,New York,2017-03-26
1785,HighMark LLC,CREDIT,3112.15,2017-03-25,1,Anthony Barnes,446735.88000000024,Connecticut,New York,2017-03-26
1786,HighMark LLC,CREDIT,3886.14,2017-03-25,1,Angela Harris,450622.02000000025,Tennessee,New York,2017-03-26
1787,HighMark LLC,CREDIT,2970.21,2017-03-25,1,Catherine Kleine,453592.2300000003,Maryland,New York,2017-03-26
1788,HighMark LLC,CREDIT,2007.49,2017-03-25,1,Bill Wagner,455599.72000000026,Portugal,New York,2017-03-26
1789,HighMark LLC,CREDIT,2840.6,2017-03-25,1,Stan Tannenbaum,458440.32000000024,Rhode Island,New York,2017-03-26
1790,HighMark LLC,CREDIT,2806.8,2017-03-25,1,Michael Rice,461247.1200000002,Rhode Island,New York,2017-03-26
1791,HighMark LLC,CREDIT,2153.85,2017-03-25,1,Samuel Carswell,463400.9700000002,Arkansas,New York,2017-03-26
1792,HighMark LLC,CREDIT,683.81,2017-03-25,1,Lois Snyder,464084.7800000002,Illinois,New York,2017-03-26
1793,HighMark LLC,CREDIT,1016.21,2017-03-26,1,Lela Ames,465100.9900000002,Idaho,New York,2017-03-27
1794,HighMark LLC,CREDIT,2201.37,2017-03-26,1,Brad Rose,467302.3600000002,Rhode Island,New York,2017-03-27
1795,HighMark LLC,CREDIT,1713.41,2017-03-26,1,Edna Niese,469015.7700000002,Virginia,New York,2017-03-27
1796,HighMark LLC,CREDIT,1211.15,2017-03-26,1,John Hill,470226.9200000002,Pennsylvania,New York,2017-03-27
1797,HighMark LLC,CREDIT,696.87,2017-03-26,1,Danny Singh,470923.7900000002,Oklahoma,New York,2017-03-27
363,HighMark LLC,DEBIT,5436.79,2017-03-26,1,Helen Melnick,465487.00000000023,New York,Ireland,2017-03-27
1798,HighMark LLC,CREDIT,1223.3,2017-03-26,1,Amy Garland,466710.3000000002,Slovenia,New York,2017-03-27
1799,HighMark LLC,CREDIT,1301.35,2017-03-26,1,Osvaldo Porter,468011.6500000002,Finland,New York,2017-03-27
1800,HighMark LLC,CREDIT,7614.24,2017-03-26,1,Beth Bruno,475625.8900000002,Ohio,New York,2017-03-27
1801,HighMark LLC,CREDIT,839.59,2017-03-27,1,Sandra Blair,476465.4800000002,North Dakota,New York,2017-03-28
1802,HighMark LLC,CREDIT,1133.95,2017-03-27,1,Jennifer Perez,477599.4300000002,France,New York,2017-03-28
1803,HighMark LLC,CREDIT,484.35,2017-03-27,1,Barbara Bale,478083.7800000002,Michigan,New York,2017-03-28
1804,HighMark LLC,CREDIT,2587.14,2017-03-27,1,William Deleon,480670.9200000002,Mississippi,New York,2017-03-28
1805,HighMark LLC,CREDIT,444.84,2017-03-27,1,Edwin Highshaw,481115.76000000024,Texas,New York,2017-03-28
1806,HighMark LLC,CREDIT,3914.01,2017-03-27,1,Samuel Carswell,485029.77000000025,Arkansas,New York,2017-03-28
1807,HighMark LLC,CREDIT,524.79,2017-03-27,1,Mae Gregory,485554.56000000023,Portugal,New York,2017-03-28
1808,HighMark LLC,CREDIT,1079.54,2017-03-27,1,Cheryl Trilli,486634.1000000002,Oregon,New York,2017-03-28
1809,HighMark LLC,CREDIT,2865.28,2017-03-27,1,Malka Cartwright,489499.38000000024,Alabama,New York,2017-03-28
1810,HighMark LLC,CREDIT,2481.32,2017-03-27,1,Brad Rose,491980.70000000024,Rhode Island,New York,2017-03-28
1811,HighMark LLC,CREDIT,3018.01,2017-03-27,1,Ann Rosa,494998.71000000025,Indiana,New York,2017-03-28
1812,HighMark LLC,CREDIT,819.97,2017-03-28,1,Matthew Ciotti,495818.6800000002,Hawaii,New York,2017-03-29
1813,HighMark LLC,CREDIT,443.53,2017-03-28,1,Edwin Highshaw,496262.21000000025,Texas,New York,2017-03-29
1814,HighMark LLC,CREDIT,3013.01,2017-03-28,1,Robert Dugger,499275.22000000026,Slovenia,New York,2017-03-29
1815,HighMark LLC,CREDIT,1745.51,2017-03-28,1,Willie Robinson,501020.7300000003,South Dakota,New York,2017-03-29
382,HighMark LLC,DEBIT,6951.0,2017-03-28,1,Renee Holden,494069.7300000003,New York,Oklahoma,2017-03-29
1816,HighMark LLC,CREDIT,1019.89,2017-03-28,1,Samuel Carswell,495089.6200000003,Arkansas,New York,2017-03-29
1817,HighMark LLC,CREDIT,2664.07,2017-03-28,1,Susan Ware,497753.6900000003,New York,New York,2017-03-29
1818,HighMark LLC,CREDIT,4326.53,2017-03-28,1,Amy Garland,502080.2200000003,Slovenia,New York,2017-03-29
1819,HighMark LLC,CREDIT,2608.11,2017-03-29,1,Georgeanna Debem,504688.3300000003,Iowa,New York,2017-03-30
1820,HighMark LLC,CREDIT,3256.81,2017-03-29,1,Bryan Mui,507945.1400000003,Hawaii,New York,2017-03-30
1821,HighMark LLC,CREDIT,2678.98,2017-03-29,1,Gabriela Hardaway,510624.1200000003,Italy,New York,2017-03-30
1822,HighMark LLC,CREDIT,2210.11,2017-03-29,1,Nancy Stutes,512834.2300000003,Nebraska,New York,2017-03-30
1823,HighMark LLC,CREDIT,1814.75,2017-03-29,1,James Cole,514648.9800000003,Wyoming,New York,2017-03-30
1824,HighMark LLC,CREDIT,2625.91,2017-03-29,1,Katie Spooner,517274.89000000025,New Mexico,New York,2017-03-30
1825,HighMark LLC,CREDIT,1587.75,2017-03-29,1,Tammy Orozco,518862.64000000025,Montana,New York,2017-03-30
393,HighMark LLC,DEBIT,5615.29,2017-03-29,1,Quincy Adamczak,513247.35000000027,New York,New Hampshire,2017-03-30
1826,HighMark LLC,CREDIT,486.76,2017-03-29,1,Susie Major,513734.1100000003,Kansas,New York,2017-03-30
1827,HighMark LLC,CREDIT,1667.58,2017-03-29,1,Melody Blakey,515401.6900000003,Slovakia,New York,2017-03-30
1828,HighMark LLC,CREDIT,907.57,2017-03-29,1,Robert Dugger,516309.2600000003,Slovenia,New York,2017-03-30
397,HighMark LLC,DEBIT,4276.45,2017-03-30,1,Amanda Alvarado,512032.8100000003,New York,Tennessee,2017-03-31
1829,HighMark LLC,CREDIT,2951.19,2017-03-30,1,Leon Birchler,514984.0000000003,Bulgaria,New York,2017-03-31
1830,HighMark LLC,CREDIT,1657.62,2017-03-30,1,Julio Mccabe,516641.6200000003,Wisconsin,New York,2017-03-31
1831,HighMark LLC,CREDIT,537.49,2017-03-30,1,Angel Hirsch,517179.1100000003,Pennsylvania,New York,2017-03-31
1832,HighMark LLC,CREDIT,3868.69,2017-03-30,1,Edwin Highshaw,521047.8000000003,Texas,New York,2017-03-31
1833,HighMark LLC,CREDIT,333.34,2017-03-30,1,Tammy Orozco,521381.1400000003,Montana,New York,2017-03-31
1834,HighMark LLC,CREDIT,741.31,2017-03-30,1,Winford Landry,522122.4500000003,Maine,New York,2017-03-31
1835,HighMark LLC,CREDIT,1459.3,2017-03-30,1,Paul Green,523581.7500000003,Portugal,New York,2017-03-31
1836,HighMark LLC,CREDIT,2830.56,2017-03-30,1,Bill Wagner,526412.3100000003,Portugal,New York,2017-03-31
1837,HighMark LLC,CREDIT,1459.0,2017-03-30,1,Nancy Stutes,527871.3100000003,Nebraska,New York,2017-03-31
1838,HighMark LLC,CREDIT,1756.82,2017-03-30,1,Vanessa Carter,529628.1300000002,Spain,New York,2017-03-31
408,HighMark LLC,DEBIT,2080.04,2017-03-31,1,Elizabeth Bruff,527548.0900000002,New York,Estonia,2017-04-01
409,HighMark LLC,DEBIT,5352.21,2017-03-31,1,Teresa Rosa,522195.8800000002,New York,Connecticut,2017-04-01
1839,HighMark LLC,CREDIT,1424.13,2017-03-31,1,Angel Hirsch,523620.0100000002,Pennsylvania,New York,2017-04-01
1840,HighMark LLC,CREDIT,3267.78,2017-03-31,1,John Hill,526887.7900000002,Pennsylvania,New York,2017-04-01
1841,HighMark LLC,CREDIT,1094.62,2017-03-31,1,Erica Toney,527982.4100000001,Latvia,New York,2017-04-01
1842,HighMark LLC,CREDIT,1319.08,2017-03-31,1,Julio Mccabe,529301.4900000001,Wisconsin,New York,2017-04-01
1843,HighMark LLC,CREDIT,2217.64,2017-03-31,1,Mark Alexander,531519.1300000001,Pennsylvania,New York,2017-04-01
1844,HighMark LLC,CREDIT,4476.98,2017-03-31,1,Donald Weber,535996.1100000001,Georgia,New York,2017-04-01
1845,HighMark LLC,CREDIT,365.18,2017-03-31,1,Carrie Morrison,536361.2900000002,Belgium,New York,2017-04-01
1846,HighMark LLC,CREDIT,936.53,2017-03-31,1,Jennifer Perez,537297.8200000002,France,New York,2017-04-01
1847,HighMark LLC,CREDIT,598.41,2017-03-31,1,Ann Rosa,537896.2300000002,Indiana,New York,2017-04-01
1848,HighMark LLC,CREDIT,1724.5,2017-03-31,1,Juanita Nichell,539620.7300000002,Indiana,New York,2017-04-01
1849,HighMark LLC,CREDIT,1442.68,2017-04-01,1,Samuel Carswell,541063.4100000003,Arkansas,New York,2017-04-02
1850,HighMark LLC,CREDIT,1371.96,2017-04-01,1,Jennifer Perez,542435.3700000002,France,New York,2017-04-02
1851,HighMark LLC,CREDIT,1213.36,2017-04-01,1,Katie Spooner,543648.7300000002,New Mexico,New York,2017-04-02
1852,HighMark LLC,CREDIT,3084.57,2017-04-01,1,Bill Wagner,546733.3000000002,Portugal,New York,2017-04-02
1853,HighMark LLC,CREDIT,1210.64,2017-04-01,1,Tammy Orozco,547943.9400000002,Montana,New York,2017-04-02
1854,HighMark LLC,CREDIT,821.92,2017-04-01,1,Victoria Laramie,548765.8600000002,Nebraska,New York,2017-04-02
1855,HighMark LLC,CREDIT,383.37,2017-04-01,1,Jason Alves,549149.2300000002,Wyoming,New York,2017-04-02
1856,HighMark LLC,CREDIT,1924.63,2017-04-01,1,Edna Jones,551073.8600000002,Latvia,New York,2017-04-02
1857,HighMark LLC,CREDIT,434.0,2017-04-01,1,Daniel Walker,551507.8600000002,South Carolina,New York,2017-04-02
1858,HighMark LLC,CREDIT,1242.89,2017-04-01,1,Laura Brant,552750.7500000002,Iowa,New York,2017-04-02
1859,HighMark LLC,CREDIT,853.11,2017-04-02,1,Ann Rosa,553603.8600000002,Indiana,New York,2017-04-03
1860,HighMark LLC,CREDIT,349.2,2017-04-02,1,Carrie Morrison,553953.0600000002,Belgium,New York,2017-04-03
1861,HighMark LLC,CREDIT,1742.55,2017-04-02,1,William Deleon,555695.6100000002,Mississippi,New York,2017-04-03
1862,HighMark LLC,CREDIT,688.24,2017-04-02,1,Danny Singh,556383.8500000002,Oklahoma,New York,2017-04-03
1863,HighMark LLC,CREDIT,967.54,2017-04-02,1,Brenda Magnuson,557351.3900000002,Austria,New York,2017-04-03
1864,HighMark LLC,CREDIT,5042.55,2017-04-02,1,Cheryl Trilli,562393.9400000003,Oregon,New York,2017-04-03
436,HighMark LLC,DEBIT,2507.74,2017-04-02,1,Quincy Adamczak,559886.2000000003,New York,New Hampshire,2017-04-03
437,HighMark LLC,DEBIT,7689.47,2017-04-02,1,Robert Price,552196.7300000003,New York,Denmark,2017-04-03
1865,HighMark LLC,CREDIT,1231.37,2017-04-02,1,Lois Snyder,553428.1000000003,Illinois,New York,2017-04-03
1866,HighMark LLC,CREDIT,1788.85,2017-04-02,1,Mike Pickerel,555216.9500000003,North Dakota,New York,2017-04-03
1867,HighMark LLC,CREDIT,1527.76,2017-04-03,1,Vanessa Carter,556744.7100000003,Spain,New York,2017-04-04
1868,HighMark LLC,CREDIT,2027.52,2017-04-03,1,Anthony Smith,558772.2300000003,Ireland,New York,2017-04-04
442,HighMark LLC,DEBIT,2484.69,2017-04-03,1,Vincent Wilson,556287.5400000004,New York,Germany,2017-04-04
1869,HighMark LLC,CREDIT,1143.76,2017-04-04,1,Gabriela Hardaway,557431.3000000004,Italy,New York,2017-04-05
444,HighMark LLC,DEBIT,2651.02,2017-04-04,1,Stephanie Snook,554780.2800000004,New York,Delaware,2017-04-05
1870,HighMark LLC,CREDIT,1368.77,2017-04-04,1,Catherine Kleine,556149.0500000004,Maryland,New York,2017-04-05
1871,HighMark LLC,CREDIT,1171.41,2017-04-04,1,Brenda Magnuson,557320.4600000004,Austria,New York,2017-04-05
1872,HighMark LLC,CREDIT,3511.18,2017-04-04,1,Samuel Carswell,560831.6400000005,Arkansas,New York,2017-04-05
1873,HighMark LLC,CREDIT,3711.69,2017-04-04,1,Ronald Mills,564543.3300000004,Netherlands,New York,2017-04-05
1874,HighMark LLC,CREDIT,2285.67,2017-04-05,1,Maricruz Culver,566829.0000000005,Maine,New York,2017-04-06
1875,HighMark LLC,CREDIT,835.03,2017-04-05,1,Malka Cartwright,567664.0300000005,Alabama,New York,2017-04-06
1876,HighMark LLC,CREDIT,2838.08,2017-04-05,1,Bryan Mui,570502.1100000005,Hawaii,New York,2017-04-06
1877,HighMark LLC,CREDIT,1247.11,2017-04-05,1,John Nguyen,571749.2200000004,Alaska,New York,2017-04-06
1878,HighMark LLC,CREDIT,1752.72,2017-04-05,1,Loren Burgess,573501.9400000004,Alabama,New York,2017-04-06
1879,HighMark LLC,CREDIT,2904.38,2017-04-05,1,Darius Sherrill,576406.3200000004,Arkansas,New York,2017-04-06
1880,HighMark LLC,CREDIT,1033.42,2017-04-06,1,William Deleon,577439.7400000005,Mississippi,New York,2017-04-07
1881,HighMark LLC,CREDIT,1408.56,2017-04-06,1,Joanne Fortin,578848.3000000005,South Carolina,New York,2017-04-07
1882,HighMark LLC,CREDIT,307.82,2017-04-06,1,James Cole,579156.1200000005,Wyoming,New York,2017-04-07
1883,HighMark LLC,CREDIT,2593.92,2017-04-06,1,Ruby Sneeden,581750.0400000005,Idaho,New York,2017-04-07
1884,HighMark LLC,CREDIT,2030.03,2017-04-06,1,Anthony Barnes,583780.0700000005,Connecticut,New York,2017-04-07
1885,HighMark LLC,CREDIT,335.65,2017-04-06,1,Edna Niese,584115.7200000006,Virginia,New York,2017-04-07
1886,HighMark LLC,CREDIT,283.64,2017-04-06,1,Jason Alves,584399.3600000006,Wyoming,New York,2017-04-07
1887,HighMark LLC,CREDIT,1280.07,2017-04-06,1,Dulce Bustos,585679.4300000005,Slovenia,New York,2017-04-07
1888,HighMark LLC,CREDIT,478.73,2017-04-07,1,Amy Garland,586158.1600000005,Slovenia,New York,2017-04-08
1889,HighMark LLC,CREDIT,716.96,2017-04-07,1,Daniel Villeneuve,586875.1200000005,South Dakota,New York,2017-04-08
1890,HighMark LLC,CREDIT,584.57,2017-04-07,1,Melody Blakey,587459.6900000004,Slovakia,New York,2017-04-08
466,HighMark LLC,DEBIT,3331.11,2017-04-07,1,Alicia Dunn,584128.5800000004,New York,Tennessee,2017-04-08
1891,HighMark LLC,CREDIT,3769.9,2017-04-07,1,Thomas Read,587898.4800000004,Arkansas,New York,2017-04-08
1892,HighMark LLC,CREDIT,372.37,2017-04-07,1,Edna Niese,588270.8500000004,Virginia,New York,2017-04-08
1893,HighMark LLC,CREDIT,2447.86,2017-04-07,1,Angela Harris,590718.7100000004,Tennessee,New York,2017-04-08
1894,HighMark LLC,CREDIT,387.13,2017-04-07,1,Sandra Blair,591105.8400000004,North Dakota,New York,2017-04-08
1895,HighMark LLC,CREDIT,1115.48,2017-04-07,1,Anthony Smith,592221.3200000004,Ireland,New York,2017-04-08
1896,HighMark LLC,CREDIT,4911.4,2017-04-07,1,Katie Spooner,597132.7200000004,New Mexico,New York,2017-04-08
1897,HighMark LLC,CREDIT,2515.65,2017-04-07,1,Tammy Orozco,599648.3700000005,Montana,New York,2017-04-08
1898,HighMark LLC,CREDIT,885.12,2017-04-07,1,Danny Singh,600533.4900000005,Oklahoma,New York,2017-04-08
1899,HighMark LLC,CREDIT,492.85,2017-04-07,1,Frankie Manners,601026.3400000004,Oregon,New York,2017-04-08
1900,HighMark LLC,CREDIT,1416.55,2017-04-07,1,Kathryn Carter,602442.8900000005,Hawaii,New York,2017-04-08
1901,HighMark LLC,CREDIT,1680.51,2017-04-08,1,Christin Walker,604123.4000000005,Arizona,New York,2017-04-09
1902,HighMark LLC,CREDIT,646.03,2017-04-08,1,Jennifer Oday,604769.4300000005,North Dakota,New York,2017-04-09
479,HighMark LLC,DEBIT,3945.55,2017-04-08,1,Shirley Valcarcel,600823.8800000005,New York,Oklahoma,2017-04-09
1903,HighMark LLC,CREDIT,719.25,2017-04-08,1,Leon Birchler,601543.1300000005,Bulgaria,New York,2017-04-09
1904,HighMark LLC,CREDIT,639.98,2017-04-09,1,Gerald Marchant,602183.1100000005,Idaho,New York,2017-04-10
482,HighMark LLC,DEBIT,6705.36,2017-04-09,1,Robert Johnson,595477.7500000005,New York,Bulgaria,2017-04-10
1905,HighMark LLC,CREDIT,1595.32,2017-04-09,1,Brenda Magnuson,597073.0700000004,Austria,New York,2017-04-10
1906,HighMark LLC,CREDIT,366.36,2017-04-09,1,Victoria Laramie,597439.4300000004,Nebraska,New York,2017-04-10
1907,HighMark LLC,CREDIT,1064.54,2017-04-10,1,Darius Sherrill,598503.9700000004,Arkansas,New York,2017-04-11
1908,HighMark LLC,CREDIT,1678.54,2017-04-10,1,Edwin Highshaw,600182.5100000005,Texas,New York,2017-04-11
1909,HighMark LLC,CREDIT,2324.71,2017-04-10,1,Melody Blakey,602507.2200000004,Slovakia,New York,2017-04-11
488,HighMark LLC,DEBIT,3423.04,2017-04-10,1,Michael Carter,599084.1800000004,New York,Luxembourg,2017-04-11
489,HighMark LLC,DEBIT,7153.43,2017-04-10,1,Ralph Palmer,591930.7500000003,New York,Wisconsin,2017-04-11
1910,HighMark LLC,CREDIT,1702.45,2017-04-10,1,Tammy Orozco,593633.2000000003,Montana,New York,2017-04-11
1911,HighMark LLC,CREDIT,1325.4,2017-04-11,1,Brad Rose,594958.6000000003,Rhode Island,New York,2017-04-12
1912,HighMark LLC,CREDIT,1144.93,2017-04-11,1,John Nguyen,596103.5300000004,Alaska,New York,2017-04-12
1913,HighMark LLC,CREDIT,738.46,2017-04-11,1,Jennifer Oday,596841.9900000003,North Dakota,New York,2017-04-12
1914,HighMark LLC,CREDIT,4692.81,2017-04-11,1,Mark Alexander,601534.8000000004,Pennsylvania,New York,2017-04-12
1915,HighMark LLC,CREDIT,565.4,2017-04-12,1,Susan Ware,602100.2000000004,New York,New York,2017-04-13
1916,HighMark LLC,CREDIT,1740.44,2017-04-12,1,Sofia Pinkerton,603840.6400000004,Arkansas,New York,2017-04-13
1917,HighMark LLC,CREDIT,1158.32,2017-04-12,1,Sandy Newkirk,604998.9600000003,Czech Republic,New York,2017-04-13
1918,HighMark LLC,CREDIT,3621.89,2017-04-12,1,Victoria Laramie,608620.8500000003,Nebraska,New York,2017-04-13
1919,HighMark LLC,CREDIT,1902.71,2017-04-12,1,Leon Birchler,610523.5600000003,Bulgaria,New York,2017-04-13
1920,HighMark LLC,CREDIT,2539.33,2017-04-12,1,Barbara Hazelrigg,613062.8900000002,Romania,New York,2017-04-13
1921,HighMark LLC,CREDIT,477.76,2017-04-12,1,Frankie Manners,613540.6500000003,Oregon,New York,2017-04-13
1922,HighMark LLC,CREDIT,2244.66,2017-04-13,1,Darius Sherrill,615785.3100000003,Arkansas,New York,2017-04-14
1923,HighMark LLC,CREDIT,1020.44,2017-04-13,1,Glenda Coots,616805.7500000002,Lithuania,New York,2017-04-14
1924,HighMark LLC,CREDIT,3655.62,2017-04-13,1,Thomas Read,620461.3700000002,Arkansas,New York,2017-04-14
1925,HighMark LLC,CREDIT,5981.6,2017-04-13,1,Edna Niese,626442.9700000002,Virginia,New York,2017-04-14
1926,HighMark LLC,CREDIT,682.56,2017-04-13,1,Bill Wagner,627125.5300000003,Portugal,New York,2017-04-14
1927,HighMark LLC,CREDIT,3276.04,2017-04-13,1,Sandra Blair,630401.5700000003,North Dakota,New York,2017-04-14
1928,HighMark LLC,CREDIT,258.28,2017-04-13,1,Cheryl Trilli,630659.8500000003,Oregon,New York,2017-04-14
1929,HighMark LLC,CREDIT,299.76,2017-04-13,1,Victoria Laramie,630959.6100000003,Nebraska,New York,2017-04-14
1930,HighMark LLC,CREDIT,3409.39,2017-04-14,1,Malka Cartwright,634369.0000000003,Alabama,New York,2017-04-15
1931,HighMark LLC,CREDIT,1546.53,2017-04-14,1,Paul Green,635915.5300000004,Portugal,New York,2017-04-15
1932,HighMark LLC,CREDIT,2436.01,2017-04-14,1,Samuel Carswell,638351.5400000004,Arkansas,New York,2017-04-15
1933,HighMark LLC,CREDIT,1568.5,2017-04-14,1,Ruby Sneeden,639920.0400000004,Idaho,New York,2017-04-15
1934,HighMark LLC,CREDIT,1289.91,2017-04-14,1,Sofia Pinkerton,641209.9500000004,Arkansas,New York,2017-04-15
1935,HighMark LLC,CREDIT,1454.7,2017-04-14,1,Julio Mccabe,642664.6500000004,Wisconsin,New York,2017-04-15
1936,HighMark LLC,CREDIT,313.77,2017-04-14,1,Sandra Blair,642978.4200000004,North Dakota,New York,2017-04-15
1937,HighMark LLC,CREDIT,2646.13,2017-04-14,1,Daniel Harrison,645624.5500000004,Louisiana,New York,2017-04-15
1938,HighMark LLC,CREDIT,1587.05,2017-04-15,1,Osvaldo Porter,647211.6000000004,Finland,New York,2017-04-16
1939,HighMark LLC,CREDIT,585.8,2017-04-15,1,Catherine Kleine,647797.4000000005,Maryland,New York,2017-04-16
1940,HighMark LLC,CREDIT,522.47,2017-04-15,1,Maricruz Culver,648319.8700000005,Maine,New York,2017-04-16
1941,HighMark LLC,CREDIT,1328.58,2017-04-15,1,William Stone,649648.4500000004,Bulgaria,New York,2017-04-16
1942,HighMark LLC,CREDIT,1010.43,2017-04-15,1,Edwin Highshaw,650658.8800000005,Texas,New York,2017-04-16
1943,HighMark LLC,CREDIT,5202.28,2017-04-15,1,Vanessa Carter,655861.1600000005,Spain,New York,2017-04-16
1944,HighMark LLC,CREDIT,4560.97,2017-04-15,1,Greg Hawkins,660422.1300000005,North Carolina,New York,2017-04-16
1945,HighMark LLC,CREDIT,1895.07,2017-04-15,1,Herbert Peevey,662317.2000000004,Sweden,New York,2017-04-16
1946,HighMark LLC,CREDIT,1490.98,2017-04-15,1,Jennifer Perez,663808.1800000004,France,New York,2017-04-16
527,HighMark LLC,DEBIT,4687.76,2017-04-15,1,Maureen Young,659120.4200000004,New York,Latvia,2017-04-16
528,HighMark LLC,DEBIT,2707.02,2017-04-15,1,Juan Cruz,656413.4000000004,New York,Florida,2017-04-16
1947,HighMark LLC,CREDIT,1435.46,2017-04-15,1,Winford Landry,657848.8600000003,Maine,New York,2017-04-16
1948,HighMark LLC,CREDIT,882.72,2017-04-16,1,Aaron Parker,658731.5800000003,Alabama,New York,2017-04-17
1949,HighMark LLC,CREDIT,2567.58,2017-04-16,1,Juanita Nichell,661299.1600000003,Indiana,New York,2017-04-17
1950,HighMark LLC,CREDIT,2279.19,2017-04-16,1,Georgeanna Debem,663578.3500000002,Iowa,New York,2017-04-17
1951,HighMark LLC,CREDIT,609.76,2017-04-16,1,Paul Green,664188.1100000002,Portugal,New York,2017-04-17
1952,HighMark LLC,CREDIT,987.13,2017-04-16,1,Matthew Ciotti,665175.2400000002,Hawaii,New York,2017-04-17
1953,HighMark LLC,CREDIT,4645.9,2017-04-16,1,Brad Rose,669821.1400000002,Rhode Island,New York,2017-04-17
1954,HighMark LLC,CREDIT,5204.49,2017-04-16,1,Gabriela Hardaway,675025.6300000002,Italy,New York,2017-04-17
1955,HighMark LLC,CREDIT,1719.63,2017-04-16,1,William Deleon,676745.2600000002,Mississippi,New York,2017-04-17
1956,HighMark LLC,CREDIT,1155.49,2017-04-16,1,Darius Sherrill,677900.7500000002,Arkansas,New York,2017-04-17
1957,HighMark LLC,CREDIT,2040.52,2017-04-16,1,Anthony Smith,679941.2700000003,Ireland,New York,2017-04-17
1958,HighMark LLC,CREDIT,706.46,2017-04-17,1,Louis Nguyen,680647.7300000002,Hungary,New York,2017-04-18
1959,HighMark LLC,CREDIT,679.63,2017-04-17,1,Winford Landry,681327.3600000002,Maine,New York,2017-04-18
542,HighMark LLC,DEBIT,2166.8,2017-04-17,1,Cathy Mccann,679160.5600000002,New York,Italy,2017-04-18
1960,HighMark LLC,CREDIT,1992.26,2017-04-17,1,John Nguyen,681152.8200000002,Alaska,New York,2017-04-18
1961,HighMark LLC,CREDIT,1396.63,2017-04-17,1,Jennifer Perez,682549.4500000002,France,New York,2017-04-18
1962,HighMark LLC,CREDIT,2949.22,2017-04-17,1,Angel Hirsch,685498.6700000002,Pennsylvania,New York,2017-04-18
1963,HighMark LLC,CREDIT,339.08,2017-04-17,1,Christin Walker,685837.7500000001,Arizona,New York,2017-04-18
1964,HighMark LLC,CREDIT,2476.93,2017-04-18,1,John Ackerman,688314.6800000002,Montana,New York,2017-04-19
1965,HighMark LLC,CREDIT,1469.69,2017-04-18,1,Ann Rosa,689784.3700000001,Indiana,New York,2017-04-19
1966,HighMark LLC,CREDIT,1616.35,2017-04-18,1,Amy Garland,691400.7200000001,Slovenia,New York,2017-04-19
1967,HighMark LLC,CREDIT,552.1,2017-04-18,1,John Nguyen,691952.8200000001,Alaska,New York,2017-04-19
1968,HighMark LLC,CREDIT,1423.53,2017-04-18,1,Edna Niese,693376.3500000001,Virginia,New York,2017-04-19
1969,HighMark LLC,CREDIT,1169.22,2017-04-18,1,Barbara Hazelrigg,694545.5700000001,Romania,New York,2017-04-19
1970,HighMark LLC,CREDIT,1162.28,2017-04-18,1,Osvaldo Porter,695707.8500000001,Finland,New York,2017-04-19
1971,HighMark LLC,CREDIT,6971.41,2017-04-18,1,Victoria Laramie,702679.2600000001,Nebraska,New York,2017-04-19
1972,HighMark LLC,CREDIT,5197.14,2017-04-18,1,Mike Pickerel,707876.4000000001,North Dakota,New York,2017-04-19
1973,HighMark LLC,CREDIT,1729.22,2017-04-18,1,Cheryl Trilli,709605.6200000001,Oregon,New York,2017-04-19
1974,HighMark LLC,CREDIT,1309.81,2017-04-18,1,Daniel Harrison,710915.4300000002,Louisiana,New York,2017-04-19
1975,HighMark LLC,CREDIT,1621.94,2017-04-18,1,Nancy Stutes,712537.3700000001,Nebraska,New York,2017-04-19
1976,HighMark LLC,CREDIT,366.39,2017-04-19,1,Ann Rosa,712903.7600000001,Indiana,New York,2017-04-20
1977,HighMark LLC,CREDIT,1362.92,2017-04-19,1,Ronald Mills,714266.6800000002,Netherlands,New York,2017-04-20
1978,HighMark LLC,CREDIT,2457.4,2017-04-19,1,Warren Nobles,716724.0800000002,Idaho,New York,2017-04-20
1979,HighMark LLC,CREDIT,1478.66,2017-04-19,1,Beth Bruno,718202.7400000002,Ohio,New York,2017-04-20
1980,HighMark LLC,CREDIT,549.73,2017-04-19,1,Susan Ware,718752.4700000002,New York,New York,2017-04-20
564,HighMark LLC,DEBIT,6693.57,2017-04-19,1,Ethan Young,712058.9000000003,New York,Lithuania,2017-04-20
1981,HighMark LLC,CREDIT,774.14,2017-04-20,1,Bill Wagner,712833.0400000003,Portugal,New York,2017-04-21
1982,HighMark LLC,CREDIT,6864.85,2017-04-20,1,James Gadbois,719697.8900000002,Maryland,New York,2017-04-21
1983,HighMark LLC,CREDIT,396.46,2017-04-20,1,Malka Cartwright,720094.3500000002,Alabama,New York,2017-04-21
1984,HighMark LLC,CREDIT,1567.93,2017-04-20,1,Willie Robinson,721662.2800000003,South Dakota,New York,2017-04-21
1985,HighMark LLC,CREDIT,2534.4,2017-04-20,1,Barbara Bale,724196.6800000003,Michigan,New York,2017-04-21
1986,HighMark LLC,CREDIT,1205.44,2017-04-20,1,Ann Rosa,725402.1200000002,Indiana,New York,2017-04-21
1987,HighMark LLC,CREDIT,4808.07,2017-04-20,1,Robert Dugger,730210.1900000002,Slovenia,New York,2017-04-21
1988,HighMark LLC,CREDIT,2380.24,2017-04-21,1,John Ackerman,732590.4300000002,Montana,New York,2017-04-22
1989,HighMark LLC,CREDIT,6800.22,2017-04-21,1,Sofia Pinkerton,739390.6500000001,Arkansas,New York,2017-04-22
1990,HighMark LLC,CREDIT,1954.97,2017-04-21,1,Edna Niese,741345.6200000001,Virginia,New York,2017-04-22
1991,HighMark LLC,CREDIT,1970.37,2017-04-21,1,Susan Ware,743315.9900000001,New York,New York,2017-04-22
576,HighMark LLC,DEBIT,1700.85,2017-04-21,1,Robert Carey,741615.1400000001,New York,Luxembourg,2017-04-22
1992,HighMark LLC,CREDIT,4839.62,2017-04-21,1,John Nguyen,746454.7600000001,Alaska,New York,2017-04-22
1993,HighMark LLC,CREDIT,4170.96,2017-04-21,1,Warren Nobles,750625.7200000001,Idaho,New York,2017-04-22
1994,HighMark LLC,CREDIT,1569.44,2017-04-22,1,Darius Sherrill,752195.16,Arkansas,New York,2017-04-23
580,HighMark LLC,DEBIT,3596.76,2017-04-22,1,Richard Williford,748598.4,New York,Michigan,2017-04-23
581,HighMark LLC,DEBIT,4200.03,2017-04-22,1,Stephanie Canfield,744398.37,New York,Hawaii,2017-04-23
1995,HighMark LLC,CREDIT,800.86,2017-04-22,1,Julio Mccabe,745199.23,Wisconsin,New York,2017-04-23
1996,HighMark LLC,CREDIT,303.76,2017-04-22,1,Sandy Newkirk,745502.99,Czech Republic,New York,2017-04-23
1997,HighMark LLC,CREDIT,277.66,2017-04-22,1,Sarah Yates,745780.65,Georgia,New York,2017-04-23
1998,HighMark LLC,CREDIT,4860.7,2017-04-22,1,Mike Pickerel,750641.35,North Dakota,New York,2017-04-23
1999,HighMark LLC,CREDIT,2754.33,2017-04-22,1,Antonette Grace,753395.6799999999,United Kingdom,New York,2017-04-23
2000,HighMark LLC,CREDIT,378.13,2017-04-22,1,Edna Niese,753773.8099999999,Virginia,New York,2017-04-23
2001,HighMark LLC,CREDIT,896.04,2017-04-22,1,Tammy Orozco,754669.85,Montana,New York,2017-04-23
2002,HighMark LLC,CREDIT,1339.57,2017-04-22,1,Lucius Majure,756009.4199999999,Wyoming,New York,2017-04-23
2003,HighMark LLC,CREDIT,3208.98,2017-04-23,1,Leon Birchler,759218.3999999999,Bulgaria,New York,2017-04-24
2004,HighMark LLC,CREDIT,744.05,2017-04-23,1,Edna Jones,759962.45,Latvia,New York,2017-04-24
2005,HighMark LLC,CREDIT,377.75,2017-04-23,1,Sandy Newkirk,760340.2,Czech Republic,New York,2017-04-24
2006,HighMark LLC,CREDIT,2391.01,2017-04-23,1,Bryan Mui,762731.21,Hawaii,New York,2017-04-24
2007,HighMark LLC,CREDIT,3494.07,2017-04-23,1,Sofia Pinkerton,766225.2799999999,Arkansas,New York,2017-04-24
2008,HighMark LLC,CREDIT,6679.37,2017-04-23,1,Tammy Orozco,772904.6499999999,Montana,New York,2017-04-24
2009,HighMark LLC,CREDIT,1178.46,2017-04-24,1,Matthew Ciotti,774083.1099999999,Hawaii,New York,2017-04-25
2010,HighMark LLC,CREDIT,1983.16,2017-04-24,1,William Stone,776066.2699999999,Bulgaria,New York,2017-04-25
2011,HighMark LLC,CREDIT,526.55,2017-04-24,1,Michael Rice,776592.82,Rhode Island,New York,2017-04-25
2012,HighMark LLC,CREDIT,2359.75,2017-04-24,1,Louis Nguyen,778952.57,Hungary,New York,2017-04-25
2013,HighMark LLC,CREDIT,1200.36,2017-04-24,1,Malka Cartwright,780152.9299999999,Alabama,New York,2017-04-25
2014,HighMark LLC,CREDIT,2834.37,2017-04-24,1,Katie Spooner,782987.2999999999,New Mexico,New York,2017-04-25
2015,HighMark LLC,CREDIT,567.91,2017-04-24,1,Lois Collier,783555.21,Estonia,New York,2017-04-25
2016,HighMark LLC,CREDIT,715.09,2017-04-24,1,Herbert Peevey,784270.2999999999,Sweden,New York,2017-04-25
2017,HighMark LLC,CREDIT,1504.18,2017-04-24,1,Angel Hirsch,785774.48,Pennsylvania,New York,2017-04-25
2018,HighMark LLC,CREDIT,349.75,2017-04-24,1,Carrie Morrison,786124.23,Belgium,New York,2017-04-25
2019,HighMark LLC,CREDIT,3035.06,2017-04-25,1,Loren Burgess,789159.29,Alabama,New York,2017-04-26
2020,HighMark LLC,CREDIT,755.7,2017-04-25,1,William Deleon,789914.99,Mississippi,New York,2017-04-26
2021,HighMark LLC,CREDIT,1848.23,2017-04-25,1,Thomas Jones,791763.22,Slovenia,New York,2017-04-26
2022,HighMark LLC,CREDIT,2915.13,2017-04-25,1,Vanessa Carter,794678.35,Spain,New York,2017-04-26
2023,HighMark LLC,CREDIT,2071.23,2017-04-25,1,Jose Chaves,796749.58,New Jersey,New York,2017-04-26
2024,HighMark LLC,CREDIT,655.08,2017-04-25,1,Warren Nobles,797404.6599999999,Idaho,New York,2017-04-26
2025,HighMark LLC,CREDIT,390.1,2017-04-25,1,Ann Rosa,797794.7599999999,Indiana,New York,2017-04-26
2026,HighMark LLC,CREDIT,864.17,2017-04-25,1,Lois Snyder,798658.9299999999,Illinois,New York,2017-04-26
2027,HighMark LLC,CREDIT,1013.31,2017-04-25,1,Winford Landry,799672.24,Maine,New York,2017-04-26
615,HighMark LLC,DEBIT,5131.59,2017-04-25,1,Philip Quinonez,794540.65,New York,Tennessee,2017-04-26
616,HighMark LLC,DEBIT,5982.63,2017-04-25,1,Reinaldo Landeros,788558.02,New York,Utah,2017-04-26
2028,HighMark LLC,CREDIT,478.47,2017-04-26,1,Malka Cartwright,789036.49,Alabama,New York,2017-04-27
2029,HighMark LLC,CREDIT,2546.23,2017-04-26,1,Vanessa Carter,791582.72,Spain,New York,2017-04-27
2030,HighMark LLC,CREDIT,1374.95,2017-04-26,1,Mike Pickerel,792957.6699999999,North Dakota,New York,2017-04-27
2031,HighMark LLC,CREDIT,2999.62,2017-04-26,1,Edna Jones,795957.2899999999,Latvia,New York,2017-04-27
2032,HighMark LLC,CREDIT,281.98,2017-04-26,1,Susie Major,796239.2699999999,Kansas,New York,2017-04-27
2033,HighMark LLC,CREDIT,4860.04,2017-04-26,1,Danny Singh,801099.3099999999,Oklahoma,New York,2017-04-27
2034,HighMark LLC,CREDIT,1873.52,2017-04-26,1,Barbara Bale,802972.83,Michigan,New York,2017-04-27
2035,HighMark LLC,CREDIT,762.72,2017-04-26,1,Erica Toney,803735.5499999999,Latvia,New York,2017-04-27
2036,HighMark LLC,CREDIT,2770.92,2017-04-26,1,Bryan Mui,806506.47,Hawaii,New York,2017-04-27
2037,HighMark LLC,CREDIT,2484.7,2017-04-26,1,Willie Robinson,808991.1699999999,South Dakota,New York,2017-04-27
627,HighMark LLC,DEBIT,6097.21,2017-04-26,1,Michael Carter,802893.96,New York,Luxembourg,2017-04-27
2038,HighMark LLC,CREDIT,2151.52,2017-04-26,1,Lois Snyder,805045.48,Illinois,New York,2017-04-27
2039,HighMark LLC,CREDIT,838.61,2017-04-27,1,Gabriela Hardaway,805884.09,Italy,New York,2017-04-28
2040,HighMark LLC,CREDIT,1099.85,2017-04-27,1,Paul Green,806983.94,Portugal,New York,2017-04-28
2041,HighMark LLC,CREDIT,1141.72,2017-04-27,1,Victoria Laramie,808125.6599999999,Nebraska,New York,2017-04-28
2042,HighMark LLC,CREDIT,1651.66,2017-04-27,1,Barbara Hazelrigg,809777.32,Romania,New York,2017-04-28
2043,HighMark LLC,CREDIT,6389.18,2017-04-27,1,Lois Snyder,816166.5,Illinois,New York,2017-04-28
2044,HighMark LLC,CREDIT,1715.0,2017-04-27,1,Warren Nobles,817881.5,Idaho,New York,2017-04-28
2045,HighMark LLC,CREDIT,426.63,2017-04-27,1,Jose Chaves,818308.13,New Jersey,New York,2017-04-28
2046,HighMark LLC,CREDIT,1175.61,2017-04-27,1,Lucius Majure,819483.74,Wyoming,New York,2017-04-28
2047,HighMark LLC,CREDIT,1645.96,2017-04-27,1,Michael Rice,821129.7,Rhode Island,New York,2017-04-28
2048,HighMark LLC,CREDIT,1513.75,2017-04-28,1,Casey Huffman,822643.45,Arkansas,New York,2017-04-29
2049,HighMark LLC,CREDIT,650.18,2017-04-28,1,Daniel Harrison,823293.63,Louisiana,New York,2017-04-29
2050,HighMark LLC,CREDIT,936.23,2017-04-28,1,James Cole,824229.86,Wyoming,New York,2017-04-29
2051,HighMark LLC,CREDIT,606.59,2017-04-28,1,Jennifer Oday,824836.45,North Dakota,New York,2017-04-29
2052,HighMark LLC,CREDIT,645.32,2017-04-28,1,Linda Henderson,825481.7699999999,Italy,New York,2017-04-29
2053,HighMark LLC,CREDIT,3805.65,2017-04-28,1,Nancy Stutes,829287.4199999999,Nebraska,New York,2017-04-29
2054,HighMark LLC,CREDIT,3413.62,2017-04-28,1,Gerald Marchant,832701.0399999999,Idaho,New York,2017-04-29
2055,HighMark LLC,CREDIT,1496.92,2017-04-29,1,Michael Rice,834197.96,Rhode Island,New York,2017-04-30
2056,HighMark LLC,CREDIT,441.75,2017-04-29,1,Brenda Magnuson,834639.71,Austria,New York,2017-04-30
2057,HighMark LLC,CREDIT,512.37,2017-04-29,1,Bill Wagner,835152.08,Portugal,New York,2017-04-30
2058,HighMark LLC,CREDIT,929.68,2017-04-29,1,Joanne Fortin,836081.76,South Carolina,New York,2017-04-30
2059,HighMark LLC,CREDIT,272.44,2017-04-29,1,Susan Ware,836354.2,New York,New York,2017-04-30
2060,HighMark LLC,CREDIT,1139.2,2017-04-29,1,Paul Green,837493.3999999999,Portugal,New York,2017-04-30
2061,HighMark LLC,CREDIT,1170.0,2017-04-30,1,Thomas Jones,838663.3999999999,Slovenia,New York,2017-05-01
2062,HighMark LLC,CREDIT,2751.86,2017-04-30,1,Amy Garland,841415.2599999999,Slovenia,New York,2017-05-01
2063,HighMark LLC,CREDIT,1115.84,2017-04-30,1,Laura Brant,842531.0999999999,Iowa,New York,2017-05-01
2064,HighMark LLC,CREDIT,2295.67,2017-04-30,1,William Deleon,844826.7699999999,Mississippi,New York,2017-05-01
2065,HighMark LLC,CREDIT,4980.55,2017-04-30,1,Joanne Fortin,849807.32,South Carolina,New York,2017-05-01
2066,HighMark LLC,CREDIT,1689.93,2017-04-30,1,Anthony Smith,851497.25,Ireland,New York,2017-05-01
2067,HighMark LLC,CREDIT,2215.52,2017-04-30,1,Edwin Highshaw,853712.77,Texas,New York,2017-05-01
2068,HighMark LLC,CREDIT,1283.68,2017-04-30,1,Kathryn Carter,854996.4500000001,Hawaii,New York,2017-05-01
2069,HighMark LLC,CREDIT,640.69,2017-04-30,1,Michael Rice,855637.14,Rhode Island,New York,2017-05-01
2070,HighMark LLC,CREDIT,2459.15,2017-04-30,1,Susan Ware,858096.29,New York,New York,2017-05-01
2071,HighMark LLC,CREDIT,3959.87,2017-05-01,1,Warren Nobles,862056.16,Idaho,New York,2017-05-02
2072,HighMark LLC,CREDIT,1160.67,2017-05-01,1,Linda Henderson,863216.8300000001,Italy,New York,2017-05-02
663,HighMark LLC,DEBIT,3529.44,2017-05-01,1,Cathy Mccann,859687.3900000001,New York,Italy,2017-05-02
664,HighMark LLC,DEBIT,2945.19,2017-05-01,1,Amber Johnson,856742.2000000002,New York,Illinois,2017-05-02
2073,HighMark LLC,CREDIT,2433.43,2017-05-01,1,Herbert Peevey,859175.6300000002,Sweden,New York,2017-05-02
2074,HighMark LLC,CREDIT,2692.53,2017-05-01,1,Nancy Stutes,861868.1600000003,Nebraska,New York,2017-05-02
2075,HighMark LLC,CREDIT,295.97,2017-05-02,1,Bryan Mui,862164.1300000002,Hawaii,New York,2017-05-03
2076,HighMark LLC,CREDIT,975.38,2017-05-02,1,Christin Walker,863139.5100000002,Arizona,New York,2017-05-03
669,HighMark LLC,DEBIT,4645.5,2017-05-02,1,Juan Hodson,858494.0100000002,New York,Hawaii,2017-05-03
2077,HighMark LLC,CREDIT,405.82,2017-05-03,1,Darius Sherrill,858899.8300000002,Arkansas,New York,2017-05-04
2078,HighMark LLC,CREDIT,1670.01,2017-05-03,1,Gabriela Hardaway,860569.8400000002,Italy,New York,2017-05-04
2079,HighMark LLC,CREDIT,788.63,2017-05-03,1,Kathryn Carter,861358.4700000002,Hawaii,New York,2017-05-04
2080,HighMark LLC,CREDIT,1453.24,2017-05-03,1,Louis Nguyen,862811.7100000002,Hungary,New York,2017-05-04
2081,HighMark LLC,CREDIT,2535.46,2017-05-03,1,William Deleon,865347.1700000002,Mississippi,New York,2017-05-04
2082,HighMark LLC,CREDIT,2212.96,2017-05-03,1,Matthew Ciotti,867560.1300000001,Hawaii,New York,2017-05-04
2083,HighMark LLC,CREDIT,340.54,2017-05-03,1,Carrie Morrison,867900.6700000002,Belgium,New York,2017-05-04
2084,HighMark LLC,CREDIT,2242.33,2017-05-03,1,Sandra Blair,870143.0000000001,North Dakota,New York,2017-05-04
2085,HighMark LLC,CREDIT,2897.37,2017-05-03,1,Christin Walker,873040.3700000001,Arizona,New York,2017-05-04
2086,HighMark LLC,CREDIT,711.07,2017-05-03,1,William Stone,873751.4400000001,Bulgaria,New York,2017-05-04
2087,HighMark LLC,CREDIT,2183.91,2017-05-03,1,Victoria Laramie,875935.3500000001,Nebraska,New York,2017-05-04
2088,HighMark LLC,CREDIT,518.8,2017-05-03,1,Jason Alves,876454.1500000001,Wyoming,New York,2017-05-04
2089,HighMark LLC,CREDIT,2206.11,2017-05-03,1,Cheryl Trilli,878660.2600000001,Oregon,New York,2017-05-04
2090,HighMark LLC,CREDIT,1530.07,2017-05-03,1,Katie Spooner,880190.3300000001,New Mexico,New York,2017-05-04
2091,HighMark LLC,CREDIT,1355.42,2017-05-04,1,James Cole,881545.7500000001,Wyoming,New York,2017-05-05
2092,HighMark LLC,CREDIT,576.59,2017-05-04,1,Connie Posey,882122.3400000001,Wisconsin,New York,2017-05-05
2093,HighMark LLC,CREDIT,1132.63,2017-05-04,1,Loren Burgess,883254.9700000001,Alabama,New York,2017-05-05
2094,HighMark LLC,CREDIT,1187.58,2017-05-04,1,Darius Sherrill,884442.55,Arkansas,New York,2017-05-05
688,HighMark LLC,DEBIT,6234.46,2017-05-04,1,Ophelia Ramirez,878208.0900000001,New York,Rhode Island,2017-05-05
2095,HighMark LLC,CREDIT,1551.28,2017-05-05,1,Frankie Manners,879759.3700000001,Oregon,New York,2017-05-06
2096,HighMark LLC,CREDIT,1986.6,2017-05-05,1,Aaron Parker,881745.9700000001,Alabama,New York,2017-05-06
2097,HighMark LLC,CREDIT,868.83,2017-05-05,1,Sarah Yates,882614.8,Georgia,New York,2017-05-06
2098,HighMark LLC,CREDIT,1703.3,2017-05-05,1,Ronald Mills,884318.1000000001,Netherlands,New York,2017-05-06
2099,HighMark LLC,CREDIT,4135.3,2017-05-05,1,Juanita Nichell,888453.4000000001,Indiana,New York,2017-05-06
2100,HighMark LLC,CREDIT,2386.39,2017-05-05,1,James Gadbois,890839.7900000002,Maryland,New York,2017-05-06
2101,HighMark LLC,CREDIT,312.94,2017-05-05,1,Ann Rosa,891152.7300000001,Indiana,New York,2017-05-06
2102,HighMark LLC,CREDIT,334.52,2017-05-06,1,William Stone,891487.2500000001,Bulgaria,New York,2017-05-07
2103,HighMark LLC,CREDIT,3835.54,2017-05-06,1,Angel Hirsch,895322.7900000002,Pennsylvania,New York,2017-05-07
2104,HighMark LLC,CREDIT,499.76,2017-05-06,1,Sandra Blair,895822.5500000002,North Dakota,New York,2017-05-07
2105,HighMark LLC,CREDIT,6244.99,2017-05-06,1,Julio Mccabe,902067.5400000002,Wisconsin,New York,2017-05-07
2106,HighMark LLC,CREDIT,1579.13,2017-05-06,1,Brad Rose,903646.6700000002,Rhode Island,New York,2017-05-07
2107,HighMark LLC,CREDIT,1539.98,2017-05-06,1,Linda Henderson,905186.6500000001,Italy,New York,2017-05-07
2108,HighMark LLC,CREDIT,613.94,2017-05-07,1,Gabriela Hardaway,905800.5900000001,Italy,New York,2017-05-08
2109,HighMark LLC,CREDIT,1203.7,2017-05-07,1,Edna Niese,907004.29,Virginia,New York,2017-05-08
2110,HighMark LLC,CREDIT,3240.44,2017-05-07,1,Angel Hirsch,910244.73,Pennsylvania,New York,2017-05-08
2111,HighMark LLC,CREDIT,1705.88,2017-05-07,1,Donald Weber,911950.61,Georgia,New York,2017-05-08
2112,HighMark LLC,CREDIT,993.91,2017-05-07,1,Osvaldo Porter,912944.52,Finland,New York,2017-05-08
2113,HighMark LLC,CREDIT,3412.17,2017-05-07,1,Michael Rice,916356.6900000001,Rhode Island,New York,2017-05-08
2114,HighMark LLC,CREDIT,1939.84,2017-05-07,1,Loren Burgess,918296.53,Alabama,New York,2017-05-08
2115,HighMark LLC,CREDIT,1475.46,2017-05-08,1,Michael Rice,919771.99,Rhode Island,New York,2017-05-09
2116,HighMark LLC,CREDIT,2203.52,2017-05-08,1,Sandy Newkirk,921975.51,Czech Republic,New York,2017-05-09
2117,HighMark LLC,CREDIT,1207.14,2017-05-08,1,Victoria Laramie,923182.65,Nebraska,New York,2017-05-09
2118,HighMark LLC,CREDIT,736.61,2017-05-08,1,Barbara Hazelrigg,923919.26,Romania,New York,2017-05-09
2119,HighMark LLC,CREDIT,3511.44,2017-05-08,1,Linda Henderson,927430.7,Italy,New York,2017-05-09
2120,HighMark LLC,CREDIT,3360.89,2017-05-09,1,Victoria Laramie,930791.59,Nebraska,New York,2017-05-10
715,HighMark LLC,DEBIT,9187.3,2017-05-09,1,Philip Quinonez,921604.2899999999,New York,Tennessee,2017-05-10
2121,HighMark LLC,CREDIT,1243.49,2017-05-09,1,Mark Alexander,922847.7799999999,Pennsylvania,New York,2017-05-10
2122,HighMark LLC,CREDIT,6821.04,2017-05-09,1,Edna Niese,929668.82,Virginia,New York,2017-05-10
2123,HighMark LLC,CREDIT,1574.65,2017-05-09,1,Edna Jones,931243.47,Latvia,New York,2017-05-10
2124,HighMark LLC,CREDIT,670.06,2017-05-10,1,Matthew Ciotti,931913.53,Hawaii,New York,2017-05-11
2125,HighMark LLC,CREDIT,3113.84,2017-05-10,1,Brad Rose,935027.37,Rhode Island,New York,2017-05-11
2126,HighMark LLC,CREDIT,7136.4,2017-05-10,1,John Hill,942163.77,Pennsylvania,New York,2017-05-11
2127,HighMark LLC,CREDIT,2254.88,2017-05-10,1,Jason Alves,944418.65,Wyoming,New York,2017-05-11
2128,HighMark LLC,CREDIT,1529.98,2017-05-10,1,Connie Posey,945948.63,Wisconsin,New York,2017-05-11
2129,HighMark LLC,CREDIT,1127.11,2017-05-10,1,Stan Tannenbaum,947075.74,Rhode Island,New York,2017-05-11
2130,HighMark LLC,CREDIT,939.36,2017-05-10,1,Georgeanna Debem,948015.1,Iowa,New York,2017-05-11
2131,HighMark LLC,CREDIT,3748.5,2017-05-11,1,Herbert Peevey,951763.6,Sweden,New York,2017-05-12
2132,HighMark LLC,CREDIT,530.46,2017-05-11,1,Warren Nobles,952294.0599999999,Idaho,New York,2017-05-12
2133,HighMark LLC,CREDIT,4479.72,2017-05-11,1,Danny Singh,956773.7799999999,Oklahoma,New York,2017-05-12
2134,HighMark LLC,CREDIT,256.02,2017-05-11,1,Louis Nguyen,957029.7999999999,Hungary,New York,2017-05-12
2135,HighMark LLC,CREDIT,1186.48,2017-05-11,1,Sandy Newkirk,958216.2799999999,Czech Republic,New York,2017-05-12
2136,HighMark LLC,CREDIT,807.49,2017-05-11,1,Gerald Alarcon,959023.7699999999,Belgium,New York,2017-05-12
2137,HighMark LLC,CREDIT,641.21,2017-05-11,1,William Stone,959664.9799999999,Bulgaria,New York,2017-05-12
2138,HighMark LLC,CREDIT,2487.91,2017-05-11,1,Juanita Nichell,962152.8899999999,Indiana,New York,2017-05-12
2139,HighMark LLC,CREDIT,889.01,2017-05-11,1,Carrie Morrison,963041.8999999999,Belgium,New York,2017-05-12
2140,HighMark LLC,CREDIT,360.4,2017-05-11,1,Angela Harris,963402.2999999999,Tennessee,New York,2017-05-12
736,HighMark LLC,DEBIT,3303.91,2017-05-11,1,Shane Stobb,960098.3899999999,New York,Texas,2017-05-12
2141,HighMark LLC,CREDIT,760.83,2017-05-12,1,Joanne Fortin,960859.2199999999,South Carolina,New York,2017-05-13
2142,HighMark LLC,CREDIT,2594.69,2017-05-12,1,Lois Collier,963453.9099999998,Estonia,New York,2017-05-13
2143,HighMark LLC,CREDIT,1045.14,2017-05-12,1,Bill Wagner,964499.0499999998,Portugal,New York,2017-05-13
2144,HighMark LLC,CREDIT,285.02,2017-05-12,1,Osvaldo Porter,964784.0699999998,Finland,New York,2017-05-13
2145,HighMark LLC,CREDIT,954.86,2017-05-12,1,Michael Rice,965738.9299999998,Rhode Island,New York,2017-05-13
2146,HighMark LLC,CREDIT,1788.69,2017-05-12,1,Linda Henderson,967527.6199999998,Italy,New York,2017-05-13
2147,HighMark LLC,CREDIT,306.58,2017-05-13,1,Mike Pickerel,967834.1999999997,North Dakota,New York,2017-05-14
2148,HighMark LLC,CREDIT,2066.12,2017-05-13,1,Linda Henderson,969900.3199999997,Italy,New York,2017-05-14
2149,HighMark LLC,CREDIT,356.75,2017-05-13,1,Donald Weber,970257.0699999997,Georgia,New York,2017-05-14
2150,HighMark LLC,CREDIT,301.66,2017-05-13,1,Jennifer Perez,970558.7299999997,France,New York,2017-05-14
2151,HighMark LLC,CREDIT,1744.87,2017-05-13,1,Barbara Hazelrigg,972303.5999999997,Romania,New York,2017-05-14
2152,HighMark LLC,CREDIT,924.59,2017-05-13,1,Robert Dugger,973228.1899999997,Slovenia,New York,2017-05-14
2153,HighMark LLC,CREDIT,1177.35,2017-05-13,1,Jason Alves,974405.5399999997,Wyoming,New York,2017-05-14
2154,HighMark LLC,CREDIT,412.04,2017-05-13,1,Mae Gregory,974817.5799999997,Portugal,New York,2017-05-14
2155,HighMark LLC,CREDIT,1206.07,2017-05-13,1,Darius Sherrill,976023.6499999997,Arkansas,New York,2017-05-14
2156,HighMark LLC,CREDIT,1426.99,2017-05-13,1,Susie Major,977450.6399999997,Kansas,New York,2017-05-14
2157,HighMark LLC,CREDIT,382.95,2017-05-13,1,Bryan Mui,977833.5899999996,Hawaii,New York,2017-05-14
2158,HighMark LLC,CREDIT,261.37,2017-05-14,1,Thomas Jones,978094.9599999996,Slovenia,New York,2017-05-15
2159,HighMark LLC,CREDIT,707.09,2017-05-14,1,Michael Rice,978802.0499999996,Rhode Island,New York,2017-05-15
2160,HighMark LLC,CREDIT,1198.77,2017-05-14,1,James Gadbois,980000.8199999996,Maryland,New York,2017-05-15
2161,HighMark LLC,CREDIT,1132.66,2017-05-14,1,Greg Hawkins,981133.4799999996,North Carolina,New York,2017-05-15
2162,HighMark LLC,CREDIT,906.12,2017-05-14,1,Gabriela Hardaway,982039.5999999996,Italy,New York,2017-05-15
2163,HighMark LLC,CREDIT,4645.39,2017-05-15,1,Malka Cartwright,986684.9899999996,Alabama,New York,2017-05-16
2164,HighMark LLC,CREDIT,2310.61,2017-05-15,1,Julio Mccabe,988995.5999999996,Wisconsin,New York,2017-05-16
2165,HighMark LLC,CREDIT,1125.52,2017-05-15,1,Sandra Blair,990121.1199999996,North Dakota,New York,2017-05-16
762,HighMark LLC,DEBIT,2750.75,2017-05-15,1,Helen Norman,987370.3699999996,New York,Wyoming,2017-05-16
2166,HighMark LLC,CREDIT,636.96,2017-05-15,1,Jason Alves,988007.3299999996,Wyoming,New York,2017-05-16
2167,HighMark LLC,CREDIT,3078.69,2017-05-15,1,Nancy Stutes,991086.0199999996,Nebraska,New York,2017-05-16
2168,HighMark LLC,CREDIT,2633.89,2017-05-15,1,Angel Hirsch,993719.9099999996,Pennsylvania,New York,2017-05-16
2169,HighMark LLC,CREDIT,8176.35,2017-05-15,1,John Hill,1001896.2599999995,Pennsylvania,New York,2017-05-16
2170,HighMark LLC,CREDIT,2197.02,2017-05-16,1,Daniel Walker,1004093.2799999996,South Carolina,New York,2017-05-17
2171,HighMark LLC,CREDIT,601.22,2017-05-16,1,Katie Spooner,1004694.4999999995,New Mexico,New York,2017-05-17
2172,HighMark LLC,CREDIT,2187.25,2017-05-16,1,James Gadbois,1006881.7499999995,Maryland,New York,2017-05-17
2173,HighMark LLC,CREDIT,814.96,2017-05-16,1,Linda Henderson,1007696.7099999995,Italy,New York,2017-05-17
2174,HighMark LLC,CREDIT,319.13,2017-05-16,1,Victoria Laramie,1008015.8399999995,Nebraska,New York,2017-05-17
2175,HighMark LLC,CREDIT,366.77,2017-05-16,1,Bill Wagner,1008382.6099999995,Portugal,New York,2017-05-17
2176,HighMark LLC,CREDIT,920.95,2017-05-16,1,Loren Burgess,1009303.5599999995,Alabama,New York,2017-05-17
2177,HighMark LLC,CREDIT,711.58,2017-05-16,1,Dulce Bustos,1010015.1399999994,Slovenia,New York,2017-05-17
2178,HighMark LLC,CREDIT,1845.32,2017-05-16,1,William Deleon,1011860.4599999994,Mississippi,New York,2017-05-17
2179,HighMark LLC,CREDIT,1959.46,2017-05-16,1,Darius Sherrill,1013819.9199999993,Arkansas,New York,2017-05-17
2180,HighMark LLC,CREDIT,661.04,2017-05-16,1,Bryan Mui,1014480.9599999994,Hawaii,New York,2017-05-17
778,HighMark LLC,DEBIT,4344.53,2017-05-16,1,Penelope Price,1010136.4299999994,New York,Texas,2017-05-17
2181,HighMark LLC,CREDIT,2296.61,2017-05-16,1,Angela Harris,1012433.0399999993,Tennessee,New York,2017-05-17
2182,HighMark LLC,CREDIT,476.36,2017-05-16,1,Edna Jones,1012909.3999999993,Latvia,New York,2017-05-17
2183,HighMark LLC,CREDIT,398.9,2017-05-16,1,Christin Walker,1013308.2999999993,Arizona,New York,2017-05-17
2184,HighMark LLC,CREDIT,718.12,2017-05-17,1,Bill Wagner,1014026.4199999993,Portugal,New York,2017-05-18
2185,HighMark LLC,CREDIT,2675.12,2017-05-17,1,Danny Singh,1016701.5399999993,Oklahoma,New York,2017-05-18
2186,HighMark LLC,CREDIT,3198.0,2017-05-17,1,Barbara Hazelrigg,1019899.5399999993,Romania,New York,2017-05-18
2187,HighMark LLC,CREDIT,637.09,2017-05-17,1,Jennifer Oday,1020536.6299999993,North Dakota,New York,2017-05-18
2188,HighMark LLC,CREDIT,442.99,2017-05-17,1,Daniel Walker,1020979.6199999993,South Carolina,New York,2017-05-18
2189,HighMark LLC,CREDIT,820.05,2017-05-17,1,Barbara Bale,1021799.6699999993,Michigan,New York,2017-05-18
2190,HighMark LLC,CREDIT,1232.52,2017-05-17,1,Carrie Morrison,1023032.1899999994,Belgium,New York,2017-05-18
2191,HighMark LLC,CREDIT,1721.2,2017-05-17,1,Katie Spooner,1024753.3899999993,New Mexico,New York,2017-05-18
2192,HighMark LLC,CREDIT,1713.98,2017-05-17,1,Angel Hirsch,1026467.3699999993,Pennsylvania,New York,2017-05-18
2193,HighMark LLC,CREDIT,696.51,2017-05-17,1,Robert Dugger,1027163.8799999993,Slovenia,New York,2017-05-18
2194,HighMark LLC,CREDIT,2549.66,2017-05-17,1,Agustin Bish,1029713.5399999993,Estonia,New York,2017-05-18
2195,HighMark LLC,CREDIT,1048.07,2017-05-17,1,Jennifer Perez,1030761.6099999993,France,New York,2017-05-18
2196,HighMark LLC,CREDIT,2142.83,2017-05-18,1,John Nguyen,1032904.4399999992,Alaska,New York,2017-05-19
2197,HighMark LLC,CREDIT,449.35,2017-05-18,1,Randi Folger,1033353.7899999992,Maryland,New York,2017-05-19
2198,HighMark LLC,CREDIT,988.15,2017-05-18,1,James Cole,1034341.9399999992,Wyoming,New York,2017-05-19
2199,HighMark LLC,CREDIT,2320.22,2017-05-18,1,Mae Gregory,1036662.1599999992,Portugal,New York,2017-05-19
2200,HighMark LLC,CREDIT,1548.24,2017-05-18,1,Vanessa Carter,1038210.3999999992,Spain,New York,2017-05-19
2201,HighMark LLC,CREDIT,5179.57,2017-05-18,1,Gerald Marchant,1043389.9699999992,Idaho,New York,2017-05-19
2202,HighMark LLC,CREDIT,1441.87,2017-05-18,1,Scott Anzalone,1044831.8399999992,New York,New York,2017-05-19
2203,HighMark LLC,CREDIT,1385.72,2017-05-18,1,Lois Collier,1046217.5599999991,Estonia,New York,2017-05-19
2204,HighMark LLC,CREDIT,6824.97,2017-05-19,1,John Hill,1053042.529999999,Pennsylvania,New York,2017-05-20
2205,HighMark LLC,CREDIT,1320.0,2017-05-19,1,Stan Tannenbaum,1054362.529999999,Rhode Island,New York,2017-05-20
2206,HighMark LLC,CREDIT,2154.98,2017-05-19,1,Cheryl Trilli,1056517.509999999,Oregon,New York,2017-05-20
2207,HighMark LLC,CREDIT,1524.08,2017-05-19,1,Casey Huffman,1058041.5899999992,Arkansas,New York,2017-05-20
806,HighMark LLC,DEBIT,1590.66,2017-05-19,1,Shannon Lazor,1056450.9299999992,New York,Alabama,2017-05-20
807,HighMark LLC,DEBIT,1921.38,2017-05-19,1,Daniel Hinnenkamp,1054529.5499999993,New York,New Mexico,2017-05-20
2208,HighMark LLC,CREDIT,285.2,2017-05-19,1,Michael Rice,1054814.7499999993,Rhode Island,New York,2017-05-20
2209,HighMark LLC,CREDIT,2752.85,2017-05-19,1,Barbara Hazelrigg,1057567.5999999994,Romania,New York,2017-05-20
2210,HighMark LLC,CREDIT,3794.99,2017-05-19,1,Amy Garland,1061362.5899999994,Slovenia,New York,2017-05-20
2211,HighMark LLC,CREDIT,2061.15,2017-05-20,1,Susan Ware,1063423.7399999993,New York,New York,2017-05-21
2212,HighMark LLC,CREDIT,2039.29,2017-05-20,1,Greg Hawkins,1065463.0299999993,North Carolina,New York,2017-05-21
2213,HighMark LLC,CREDIT,482.58,2017-05-20,1,John Nguyen,1065945.6099999994,Alaska,New York,2017-05-21
2214,HighMark LLC,CREDIT,340.87,2017-05-20,1,Jason Alves,1066286.4799999995,Wyoming,New York,2017-05-21
815,HighMark LLC,DEBIT,4702.71,2017-05-20,1,Martha Switzer,1061583.7699999996,New York,Montana,2017-05-21
2215,HighMark LLC,CREDIT,544.53,2017-05-20,1,Edna Niese,1062128.2999999996,Virginia,New York,2017-05-21
2216,HighMark LLC,CREDIT,1377.71,2017-05-20,1,Lois Snyder,1063506.0099999995,Illinois,New York,2017-05-21
2217,HighMark LLC,CREDIT,3566.76,2017-05-21,1,Malka Cartwright,1067072.7699999996,Alabama,New York,2017-05-22
2218,HighMark LLC,CREDIT,2585.07,2017-05-21,1,Willie Robinson,1069657.8399999996,South Dakota,New York,2017-05-22
2219,HighMark LLC,CREDIT,319.44,2017-05-21,1,Dulce Bustos,1069977.2799999996,Slovenia,New York,2017-05-22
2220,HighMark LLC,CREDIT,850.58,2017-05-21,1,Christin Walker,1070827.8599999996,Arizona,New York,2017-05-22
2221,HighMark LLC,CREDIT,411.37,2017-05-21,1,Warren Nobles,1071239.2299999997,Idaho,New York,2017-05-22
2222,HighMark LLC,CREDIT,1670.82,2017-05-21,1,Samuel Carswell,1072910.0499999998,Arkansas,New York,2017-05-22
2223,HighMark LLC,CREDIT,631.93,2017-05-21,1,Susan Ware,1073541.9799999997,New York,New York,2017-05-22
825,HighMark LLC,DEBIT,2180.37,2017-05-21,1,William Biagioni,1071361.6099999996,New York,France,2017-05-22
826,HighMark LLC,DEBIT,11101.32,2017-05-21,1,Grace Haselton,1060260.2899999996,New York,India,2017-05-22
2224,HighMark LLC,CREDIT,2392.11,2017-05-22,1,Sofia Pinkerton,1062652.3999999997,Arkansas,New York,2017-05-23
2225,HighMark LLC,CREDIT,5048.44,2017-05-22,1,Daniel Harrison,1067700.8399999996,Louisiana,New York,2017-05-23
2226,HighMark LLC,CREDIT,1532.88,2017-05-22,1,Barbara Bale,1069233.7199999995,Michigan,New York,2017-05-23
2227,HighMark LLC,CREDIT,820.72,2017-05-22,1,Samuel Carswell,1070054.4399999995,Arkansas,New York,2017-05-23
2228,HighMark LLC,CREDIT,3289.03,2017-05-22,1,Leon Birchler,1073343.4699999995,Bulgaria,New York,2017-05-23
832,HighMark LLC,DEBIT,9426.02,2017-05-22,1,Gwendolyn Morrison,1063917.4499999995,New York,Maryland,2017-05-23
2229,HighMark LLC,CREDIT,1126.9,2017-05-22,1,Bill Wagner,1065044.3499999994,Portugal,New York,2017-05-23
2230,HighMark LLC,CREDIT,901.96,2017-05-22,1,Laura Brant,1065946.3099999994,Iowa,New York,2017-05-23
2231,HighMark LLC,CREDIT,1998.98,2017-05-23,1,Bryan Mui,1067945.2899999993,Hawaii,New York,2017-05-24
2232,HighMark LLC,CREDIT,265.04,2017-05-23,1,Christin Walker,1068210.3299999994,Arizona,New York,2017-05-24
2233,HighMark LLC,CREDIT,2152.93,2017-05-23,1,Warren Nobles,1070363.2599999993,Idaho,New York,2017-05-24
2234,HighMark LLC,CREDIT,2386.68,2017-05-23,1,Ann Rosa,1072749.9399999992,Indiana,New York,2017-05-24
2235,HighMark LLC,CREDIT,685.86,2017-05-23,1,Glenda Coots,1073435.7999999993,Lithuania,New York,2017-05-24
2236,HighMark LLC,CREDIT,1038.69,2017-05-23,1,Matthew Ciotti,1074474.4899999993,Hawaii,New York,2017-05-24
2237,HighMark LLC,CREDIT,580.49,2017-05-23,1,Lois Collier,1075054.9799999993,Estonia,New York,2017-05-24
2238,HighMark LLC,CREDIT,3182.91,2017-05-23,1,Robert Dugger,1078237.8899999992,Slovenia,New York,2017-05-24
2239,HighMark LLC,CREDIT,3236.83,2017-05-23,1,Randi Folger,1081474.7199999993,Maryland,New York,2017-05-24
2240,HighMark LLC,CREDIT,706.83,2017-05-23,1,Anthony Smith,1082181.5499999993,Ireland,New York,2017-05-24
2241,HighMark LLC,CREDIT,1065.39,2017-05-23,1,Mike Pickerel,1083246.9399999992,North Dakota,New York,2017-05-24
2242,HighMark LLC,CREDIT,1709.77,2017-05-24,1,John Nguyen,1084956.7099999993,Alaska,New York,2017-05-25
2243,HighMark LLC,CREDIT,2242.48,2017-05-24,1,Leon Birchler,1087199.1899999992,Bulgaria,New York,2017-05-25
2244,HighMark LLC,CREDIT,624.5,2017-05-24,1,Bryan Mui,1087823.6899999992,Hawaii,New York,2017-05-25
2245,HighMark LLC,CREDIT,2133.4,2017-05-24,1,Louis Nguyen,1089957.0899999992,Hungary,New York,2017-05-25
2246,HighMark LLC,CREDIT,3241.15,2017-05-24,1,Edna Niese,1093198.239999999,Virginia,New York,2017-05-25
2247,HighMark LLC,CREDIT,592.47,2017-05-24,1,Anthony Barnes,1093790.709999999,Connecticut,New York,2017-05-25
2248,HighMark LLC,CREDIT,1630.48,2017-05-24,1,Greg Hawkins,1095421.189999999,North Carolina,New York,2017-05-25
2249,HighMark LLC,CREDIT,2084.26,2017-05-24,1,Edna Jones,1097505.449999999,Latvia,New York,2017-05-25
2250,HighMark LLC,CREDIT,549.53,2017-05-25,1,Frankie Manners,1098054.979999999,Oregon,New York,2017-05-26
2251,HighMark LLC,CREDIT,956.07,2017-05-25,1,Jason Alves,1099011.049999999,Wyoming,New York,2017-05-26
2252,HighMark LLC,CREDIT,1586.09,2017-05-25,1,John Nguyen,1100597.1399999992,Alaska,New York,2017-05-26
2253,HighMark LLC,CREDIT,609.78,2017-05-25,1,John Hill,1101206.9199999992,Pennsylvania,New York,2017-05-26
2254,HighMark LLC,CREDIT,314.15,2017-05-25,1,Barbara Hazelrigg,1101521.0699999991,Romania,New York,2017-05-26
859,HighMark LLC,DEBIT,8808.52,2017-05-25,1,Grace Haselton,1092712.549999999,New York,India,2017-05-26
2255,HighMark LLC,CREDIT,606.66,2017-05-25,1,Bryan Mui,1093319.209999999,Hawaii,New York,2017-05-26
2256,HighMark LLC,CREDIT,1413.99,2017-05-25,1,Jennifer Perez,1094733.199999999,France,New York,2017-05-26
2257,HighMark LLC,CREDIT,1034.8,2017-05-25,1,Angela Harris,1095767.999999999,Tennessee,New York,2017-05-26
2258,HighMark LLC,CREDIT,1368.8,2017-05-26,1,Linda Henderson,1097136.799999999,Italy,New York,2017-05-27
2259,HighMark LLC,CREDIT,4399.96,2017-05-26,1,Danny Singh,1101536.759999999,Oklahoma,New York,2017-05-27
2260,HighMark LLC,CREDIT,1017.74,2017-05-26,1,Christin Walker,1102554.499999999,Arizona,New York,2017-05-27
2261,HighMark LLC,CREDIT,2447.68,2017-05-26,1,Bill Wagner,1105002.179999999,Portugal,New York,2017-05-27
2262,HighMark LLC,CREDIT,1300.89,2017-05-26,1,Samuel Carswell,1106303.069999999,Arkansas,New York,2017-05-27
2263,HighMark LLC,CREDIT,6043.51,2017-05-27,1,Randi Folger,1112346.579999999,Maryland,New York,2017-05-28
2264,HighMark LLC,CREDIT,566.91,2017-05-27,1,Cheryl Trilli,1112913.4899999988,Oregon,New York,2017-05-28
2265,HighMark LLC,CREDIT,3705.2,2017-05-27,1,Sofia Pinkerton,1116618.6899999988,Arkansas,New York,2017-05-28
2266,HighMark LLC,CREDIT,331.11,2017-05-27,1,Angel Hirsch,1116949.7999999989,Pennsylvania,New York,2017-05-28
2267,HighMark LLC,CREDIT,2067.48,2017-05-27,1,Lois Snyder,1119017.2799999989,Illinois,New York,2017-05-28
2268,HighMark LLC,CREDIT,5210.57,2017-05-27,1,Dulce Bustos,1124227.849999999,Slovenia,New York,2017-05-28
874,HighMark LLC,DEBIT,12333.08,2017-05-27,1,Grace Haselton,1111894.7699999989,New York,India,2017-05-28
2269,HighMark LLC,CREDIT,2039.2,2017-05-27,1,Warren Nobles,1113933.9699999988,Idaho,New York,2017-05-28
876,HighMark LLC,DEBIT,11717.22,2017-05-28,1,Maureen Young,1102216.7499999988,New York,Latvia,2017-05-29
877,HighMark LLC,DEBIT,1591.35,2017-05-28,1,Crystal Gibson,1100625.3999999987,New York,Colorado,2017-05-29
2270,HighMark LLC,CREDIT,3246.26,2017-05-28,1,Dulce Bustos,1103871.6599999988,Slovenia,New York,2017-05-29
2271,HighMark LLC,CREDIT,1856.11,2017-05-28,1,Cheryl Trilli,1105727.7699999989,Oregon,New York,2017-05-29
2272,HighMark LLC,CREDIT,1432.36,2017-05-28,1,Robert Dugger,1107160.129999999,Slovenia,New York,2017-05-29
2273,HighMark LLC,CREDIT,519.44,2017-05-28,1,Bryan Mui,1107679.569999999,Hawaii,New York,2017-05-29
2274,HighMark LLC,CREDIT,1911.76,2017-05-28,1,Laura Brant,1109591.329999999,Iowa,New York,2017-05-29
2275,HighMark LLC,CREDIT,3669.58,2017-05-28,1,Warren Nobles,1113260.909999999,Idaho,New York,2017-05-29
2276,HighMark LLC,CREDIT,500.37,2017-05-28,1,James Cole,1113761.279999999,Wyoming,New York,2017-05-29
2277,HighMark LLC,CREDIT,3385.89,2017-05-29,1,Erica Toney,1117147.169999999,Latvia,New York,2017-05-30
886,HighMark LLC,DEBIT,3581.28,2017-05-29,1,William Obyrne,1113565.889999999,New York,Estonia,2017-05-30
2278,HighMark LLC,CREDIT,1470.54,2017-05-29,1,Willie Robinson,1115036.429999999,South Dakota,New York,2017-05-30
2279,HighMark LLC,CREDIT,492.5,2017-05-29,1,Stan Tannenbaum,1115528.929999999,Rhode Island,New York,2017-05-30
2280,HighMark LLC,CREDIT,312.72,2017-05-29,1,Agustin Bish,1115841.649999999,Estonia,New York,2017-05-30
2281,HighMark LLC,CREDIT,2764.76,2017-05-29,1,Malka Cartwright,1118606.409999999,Alabama,New York,2017-05-30
2282,HighMark LLC,CREDIT,1594.98,2017-05-29,1,Glenda Coots,1120201.389999999,Lithuania,New York,2017-05-30
2283,HighMark LLC,CREDIT,344.11,2017-05-29,1,John Hill,1120545.499999999,Pennsylvania,New York,2017-05-30
2284,HighMark LLC,CREDIT,550.48,2017-05-29,1,William Deleon,1121095.979999999,Mississippi,New York,2017-05-30
2285,HighMark LLC,CREDIT,4460.41,2017-05-29,1,Bryan Mui,1125556.389999999,Hawaii,New York,2017-05-30
2286,HighMark LLC,CREDIT,1501.58,2017-05-30,1,Joanne Fortin,1127057.969999999,South Carolina,New York,2017-05-31
2287,HighMark LLC,CREDIT,1797.97,2017-05-30,1,Robert Dugger,1128855.939999999,Slovenia,New York,2017-05-31
2288,HighMark LLC,CREDIT,1452.91,2017-05-30,1,Cheryl Trilli,1130308.849999999,Oregon,New York,2017-05-31
2289,HighMark LLC,CREDIT,746.52,2017-05-30,1,Agustin Bish,1131055.369999999,Estonia,New York,2017-05-31
2290,HighMark LLC,CREDIT,1732.96,2017-05-30,1,Ronald Mills,1132788.329999999,Netherlands,New York,2017-05-31
2291,HighMark LLC,CREDIT,2093.07,2017-05-30,1,Aaron Parker,1134881.399999999,Alabama,New York,2017-05-31
2292,HighMark LLC,CREDIT,2159.46,2017-05-30,1,Susan Ware,1137040.859999999,New York,New York,2017-05-31
2293,HighMark LLC,CREDIT,3411.14,2017-05-30,1,Lucius Majure,1140451.9999999988,Wyoming,New York,2017-05-31
903,HighMark LLC,DEBIT,4825.28,2017-05-30,1,William Obyrne,1135626.7199999988,New York,Estonia,2017-05-31
904,HighMark LLC,DEBIT,5272.67,2017-05-30,1,Gary Staubin,1130354.0499999989,New York,New York,2017-05-31
2294,HighMark LLC,CREDIT,2936.14,2017-05-31,1,Malka Cartwright,1133290.1899999988,Alabama,New York,2017-06-01
2295,HighMark LLC,CREDIT,286.71,2017-05-31,1,Danny Singh,1133576.8999999987,Oklahoma,New York,2017-06-01
2296,HighMark LLC,CREDIT,1553.54,2017-05-31,1,Frank Tafel,1135130.4399999988,Finland,New York,2017-06-01
2297,HighMark LLC,CREDIT,340.54,2017-05-31,1,Ann Rosa,1135470.9799999988,Indiana,New York,2017-06-01
2298,HighMark LLC,CREDIT,931.79,2017-05-31,1,Donald Weber,1136402.7699999989,Georgia,New York,2017-06-01
2299,HighMark LLC,CREDIT,440.45,2017-05-31,1,William Deleon,1136843.2199999988,Mississippi,New York,2017-06-01
2300,HighMark LLC,CREDIT,1577.03,2017-05-31,1,Edna Niese,1138420.2499999988,Virginia,New York,2017-06-01
2301,HighMark LLC,CREDIT,4523.46,2017-05-31,1,Jason Alves,1142943.7099999988,Wyoming,New York,2017-06-01
2302,HighMark LLC,CREDIT,1162.4,2017-06-01,1,Joanne Fortin,1144106.1099999987,South Carolina,New York,2017-06-02
2303,HighMark LLC,CREDIT,919.06,2017-06-01,1,Sandy Newkirk,1145025.1699999988,Czech Republic,New York,2017-06-02
2304,HighMark LLC,CREDIT,345.9,2017-06-01,1,Barbara Hazelrigg,1145371.0699999987,Romania,New York,2017-06-02
2305,HighMark LLC,CREDIT,365.62,2017-06-01,1,Randi Folger,1145736.6899999988,Maryland,New York,2017-06-02
2306,HighMark LLC,CREDIT,755.67,2017-06-01,1,Lois Collier,1146492.3599999987,Estonia,New York,2017-06-02
2307,HighMark LLC,CREDIT,4855.63,2017-06-01,1,Samuel Carswell,1151347.9899999986,Arkansas,New York,2017-06-02
2308,HighMark LLC,CREDIT,3426.01,2017-06-01,1,Gabriela Hardaway,1154773.9999999986,Italy,New York,2017-06-02
2309,HighMark LLC,CREDIT,3635.23,2017-06-01,1,Brenda Magnuson,1158409.2299999986,Austria,New York,2017-06-02
2310,HighMark LLC,CREDIT,263.35,2017-06-01,1,Susan Ware,1158672.5799999987,New York,New York,2017-06-02
2311,HighMark LLC,CREDIT,839.61,2017-06-01,1,William Stone,1159512.1899999988,Bulgaria,New York,2017-06-02
2312,HighMark LLC,CREDIT,1280.39,2017-06-01,1,Lois Snyder,1160792.5799999987,Illinois,New York,2017-06-02
2313,HighMark LLC,CREDIT,1298.91,2017-06-01,1,Bryan Mui,1162091.4899999986,Hawaii,New York,2017-06-02
2314,HighMark LLC,CREDIT,302.98,2017-06-01,1,Michael Rice,1162394.4699999986,Rhode Island,New York,2017-06-02
2315,HighMark LLC,CREDIT,665.5,2017-06-02,1,Louis Nguyen,1163059.9699999986,Hungary,New York,2017-06-03
2316,HighMark LLC,CREDIT,1456.53,2017-06-02,1,Samuel Carswell,1164516.4999999986,Arkansas,New York,2017-06-03
2317,HighMark LLC,CREDIT,788.81,2017-06-02,1,Mark Alexander,1165305.3099999987,Pennsylvania,New York,2017-06-03
2318,HighMark LLC,CREDIT,2175.64,2017-06-02,1,Georgeanna Debem,1167480.9499999986,Iowa,New York,2017-06-03
2319,HighMark LLC,CREDIT,739.6,2017-06-02,1,Robert Dugger,1168220.5499999986,Slovenia,New York,2017-06-03
2320,HighMark LLC,CREDIT,1823.1,2017-06-02,1,Loren Burgess,1170043.6499999987,Alabama,New York,2017-06-03
2321,HighMark LLC,CREDIT,1218.52,2017-06-02,1,Lois Snyder,1171262.1699999988,Illinois,New York,2017-06-03
2322,HighMark LLC,CREDIT,2214.75,2017-06-02,1,Sarah Yates,1173476.9199999988,Georgia,New York,2017-06-03
2323,HighMark LLC,CREDIT,4556.43,2017-06-02,1,Connie Posey,1178033.3499999987,Wisconsin,New York,2017-06-03
2324,HighMark LLC,CREDIT,3490.14,2017-06-02,1,Katie Spooner,1181523.4899999986,New Mexico,New York,2017-06-03
2325,HighMark LLC,CREDIT,363.95,2017-06-03,1,Michael Rice,1181887.4399999985,Rhode Island,New York,2017-06-04
2326,HighMark LLC,CREDIT,1225.97,2017-06-03,1,Casey Huffman,1183113.4099999985,Arkansas,New York,2017-06-04
2327,HighMark LLC,CREDIT,321.61,2017-06-03,1,Paul Green,1183435.0199999986,Portugal,New York,2017-06-04
2328,HighMark LLC,CREDIT,2802.43,2017-06-04,1,Sarah Yates,1186237.4499999986,Georgia,New York,2017-06-05
2329,HighMark LLC,CREDIT,1592.85,2017-06-04,1,Bryan Mui,1187830.2999999986,Hawaii,New York,2017-06-05
2330,HighMark LLC,CREDIT,485.44,2017-06-04,1,Susan Ware,1188315.7399999986,New York,New York,2017-06-05
2331,HighMark LLC,CREDIT,518.36,2017-06-04,1,Leon Birchler,1188834.0999999987,Bulgaria,New York,2017-06-05
2332,HighMark LLC,CREDIT,353.1,2017-06-04,1,Linda Henderson,1189187.1999999988,Italy,New York,2017-06-05
2333,HighMark LLC,CREDIT,2221.45,2017-06-05,1,Catherine Kleine,1191408.6499999987,Maryland,New York,2017-06-06
2334,HighMark LLC,CREDIT,3070.58,2017-06-05,1,Juanita Nichell,1194479.2299999988,Indiana,New York,2017-06-06
2335,HighMark LLC,CREDIT,1814.31,2017-06-05,1,Linda Henderson,1196293.5399999989,Italy,New York,2017-06-06
2336,HighMark LLC,CREDIT,2295.18,2017-06-05,1,Victoria Laramie,1198588.7199999988,Nebraska,New York,2017-06-06
2337,HighMark LLC,CREDIT,2067.61,2017-06-05,1,Vanessa Carter,1200656.329999999,Spain,New York,2017-06-06
949,HighMark LLC,DEBIT,2925.14,2017-06-05,1,Willie Thompson,1197731.189999999,New York,Slovenia,2017-06-06
2338,HighMark LLC,CREDIT,680.47,2017-06-05,1,Joanne Fortin,1198411.659999999,South Carolina,New York,2017-06-06
2339,HighMark LLC,CREDIT,464.06,2017-06-06,1,Dulce Bustos,1198875.719999999,Slovenia,New York,2017-06-07
2340,HighMark LLC,CREDIT,3345.75,2017-06-06,1,William Deleon,1202221.469999999,Mississippi,New York,2017-06-07
2341,HighMark LLC,CREDIT,2581.59,2017-06-06,1,Catherine Kleine,1204803.0599999991,Maryland,New York,2017-06-07
2342,HighMark LLC,CREDIT,3399.39,2017-06-06,1,Frank Tafel,1208202.449999999,Finland,New York,2017-06-07
2343,HighMark LLC,CREDIT,715.29,2017-06-06,1,Bryan Mui,1208917.739999999,Hawaii,New York,2017-06-07
956,HighMark LLC,DEBIT,2161.22,2017-06-06,1,Grace Krafft,1206756.519999999,New York,North Carolina,2017-06-07
2344,HighMark LLC,CREDIT,572.61,2017-06-06,1,Danny Singh,1207329.1299999992,Oklahoma,New York,2017-06-07
2345,HighMark LLC,CREDIT,1154.56,2017-06-06,1,Stan Tannenbaum,1208483.6899999992,Rhode Island,New York,2017-06-07
2346,HighMark LLC,CREDIT,1108.66,2017-06-07,1,Edwin Highshaw,1209592.3499999992,Texas,New York,2017-06-08
2347,HighMark LLC,CREDIT,2801.34,2017-06-07,1,Herbert Peevey,1212393.6899999992,Sweden,New York,2017-06-08
2348,HighMark LLC,CREDIT,458.63,2017-06-07,1,Robert Dugger,1212852.3199999991,Slovenia,New York,2017-06-08
2349,HighMark LLC,CREDIT,1639.92,2017-06-07,1,Kathryn Carter,1214492.239999999,Hawaii,New York,2017-06-08
2350,HighMark LLC,CREDIT,1647.54,2017-06-07,1,Mae Gregory,1216139.779999999,Portugal,New York,2017-06-08
2351,HighMark LLC,CREDIT,5405.65,2017-06-07,1,Barbara Bale,1221545.429999999,Michigan,New York,2017-06-08
2352,HighMark LLC,CREDIT,2340.3,2017-06-07,1,Bill Wagner,1223885.729999999,Portugal,New York,2017-06-08
2353,HighMark LLC,CREDIT,2181.02,2017-06-07,1,Maricruz Culver,1226066.749999999,Maine,New York,2017-06-08
2354,HighMark LLC,CREDIT,1820.01,2017-06-07,1,William Deleon,1227886.759999999,Mississippi,New York,2017-06-08
2355,HighMark LLC,CREDIT,804.59,2017-06-07,1,Malka Cartwright,1228691.3499999992,Alabama,New York,2017-06-08
2356,HighMark LLC,CREDIT,452.91,2017-06-08,1,Angel Hirsch,1229144.259999999,Pennsylvania,New York,2017-06-09
2357,HighMark LLC,CREDIT,445.5,2017-06-08,1,Sandra Blair,1229589.759999999,North Dakota,New York,2017-06-09
2358,HighMark LLC,CREDIT,746.78,2017-06-08,1,Darius Sherrill,1230336.539999999,Arkansas,New York,2017-06-09
2359,HighMark LLC,CREDIT,1720.67,2017-06-08,1,Donald Weber,1232057.209999999,Georgia,New York,2017-06-09
2360,HighMark LLC,CREDIT,1113.8,2017-06-08,1,Mike Pickerel,1233171.009999999,North Dakota,New York,2017-06-09
2361,HighMark LLC,CREDIT,3270.63,2017-06-08,1,Barbara Hazelrigg,1236441.639999999,Romania,New York,2017-06-09
2362,HighMark LLC,CREDIT,603.71,2017-06-08,1,John Hill,1237045.349999999,Pennsylvania,New York,2017-06-09
2363,HighMark LLC,CREDIT,929.92,2017-06-08,1,Linda Henderson,1237975.2699999989,Italy,New York,2017-06-09
2364,HighMark LLC,CREDIT,305.12,2017-06-08,1,Malka Cartwright,1238280.389999999,Alabama,New York,2017-06-09
2365,HighMark LLC,CREDIT,836.55,2017-06-08,1,Laura Brant,1239116.939999999,Iowa,New York,2017-06-09
979,HighMark LLC,DEBIT,1889.98,2017-06-09,1,William Biagioni,1237226.959999999,New York,France,2017-06-10
2366,HighMark LLC,CREDIT,326.91,2017-06-09,1,Brenda Magnuson,1237553.869999999,Austria,New York,2017-06-10
2367,HighMark LLC,CREDIT,433.14,2017-06-09,1,Barbara Bale,1237987.0099999988,Michigan,New York,2017-06-10
2368,HighMark LLC,CREDIT,3133.34,2017-06-09,1,Susan Ware,1241120.349999999,New York,New York,2017-06-10
2369,HighMark LLC,CREDIT,5187.88,2017-06-09,1,Danny Singh,1246308.2299999988,Oklahoma,New York,2017-06-10
2370,HighMark LLC,CREDIT,1413.66,2017-06-09,1,Frankie Manners,1247721.8899999987,Oregon,New York,2017-06-10
2371,HighMark LLC,CREDIT,897.01,2017-06-09,1,Linda Henderson,1248618.8999999987,Italy,New York,2017-06-10
2372,HighMark LLC,CREDIT,1495.67,2017-06-09,1,Jennifer Perez,1250114.5699999987,France,New York,2017-06-10
2373,HighMark LLC,CREDIT,510.09,2017-06-09,1,Samuel Carswell,1250624.6599999988,Arkansas,New York,2017-06-10
2374,HighMark LLC,CREDIT,1259.32,2017-06-09,1,Tammy Orozco,1251883.9799999988,Montana,New York,2017-06-10
2375,HighMark LLC,CREDIT,3946.47,2017-06-10,1,Daniel Harrison,1255830.4499999988,Louisiana,New York,2017-06-11
2376,HighMark LLC,CREDIT,877.3,2017-06-10,1,Warren Nobles,1256707.7499999988,Idaho,New York,2017-06-11
2377,HighMark LLC,CREDIT,2595.03,2017-06-10,1,Juanita Nichell,1259302.7799999989,Indiana,New York,2017-06-11
2378,HighMark LLC,CREDIT,3260.5,2017-06-10,1,Amy Garland,1262563.2799999989,Slovenia,New York,2017-06-11
2379,HighMark LLC,CREDIT,572.07,2017-06-10,1,Susan Ware,1263135.349999999,New York,New York,2017-06-11
2380,HighMark LLC,CREDIT,2749.23,2017-06-10,1,Jennifer Perez,1265884.579999999,France,New York,2017-06-11
2381,HighMark LLC,CREDIT,449.44,2017-06-10,1,Edna Jones,1266334.0199999989,Latvia,New York,2017-06-11
2382,HighMark LLC,CREDIT,3111.24,2017-06-11,1,Joanne Fortin,1269445.2599999988,South Carolina,New York,2017-06-12
2383,HighMark LLC,CREDIT,2879.04,2017-06-11,1,Lois Snyder,1272324.2999999989,Illinois,New York,2017-06-12
2384,HighMark LLC,CREDIT,3780.55,2017-06-11,1,Barbara Hazelrigg,1276104.849999999,Romania,New York,2017-06-12
2385,HighMark LLC,CREDIT,377.24,2017-06-11,1,Daniel Harrison,1276482.089999999,Louisiana,New York,2017-06-12
2386,HighMark LLC,CREDIT,2093.97,2017-06-12,1,Samuel Carswell,1278576.059999999,Arkansas,New York,2017-06-13
2387,HighMark LLC,CREDIT,1536.33,2017-06-12,1,Matthew Ciotti,1280112.389999999,Hawaii,New York,2017-06-13
2388,HighMark LLC,CREDIT,2356.97,2017-06-12,1,Jason Alves,1282469.359999999,Wyoming,New York,2017-06-13
2389,HighMark LLC,CREDIT,1114.15,2017-06-12,1,Jennifer Perez,1283583.5099999988,France,New York,2017-06-13
2390,HighMark LLC,CREDIT,3668.77,2017-06-12,1,Sandra Blair,1287252.2799999989,North Dakota,New York,2017-06-13
2391,HighMark LLC,CREDIT,1660.86,2017-06-12,1,Edwin Highshaw,1288913.139999999,Texas,New York,2017-06-13
2392,HighMark LLC,CREDIT,255.46,2017-06-12,1,Kathryn Carter,1289168.599999999,Hawaii,New York,2017-06-13
2393,HighMark LLC,CREDIT,1730.59,2017-06-12,1,Daniel Walker,1290899.189999999,South Carolina,New York,2017-06-13
2394,HighMark LLC,CREDIT,701.42,2017-06-12,1,Christin Walker,1291600.609999999,Arizona,New York,2017-06-13
2395,HighMark LLC,CREDIT,1548.59,2017-06-12,1,Loren Burgess,1293149.199999999,Alabama,New York,2017-06-13
2396,HighMark LLC,CREDIT,430.68,2017-06-12,1,Barbara Bale,1293579.879999999,Michigan,New York,2017-06-13
2397,HighMark LLC,CREDIT,1094.5,2017-06-12,1,Michael Rice,1294674.379999999,Rhode Island,New York,2017-06-13
2398,HighMark LLC,CREDIT,1238.08,2017-06-13,1,Loren Burgess,1295912.459999999,Alabama,New York,2017-06-14
1013,HighMark LLC,DEBIT,4725.28,2017-06-13,1,Jessie Johnson,1291187.179999999,New York,North Dakota,2017-06-14
2399,HighMark LLC,CREDIT,3032.87,2017-06-13,1,Robert Dugger,1294220.049999999,Slovenia,New York,2017-06-14
2400,HighMark LLC,CREDIT,2120.81,2017-06-13,1,John Ackerman,1296340.8599999992,Montana,New York,2017-06-14
2401,HighMark LLC,CREDIT,1419.21,2017-06-13,1,Darius Sherrill,1297760.0699999991,Arkansas,New York,2017-06-14
2402,HighMark LLC,CREDIT,4247.09,2017-06-13,1,Katie Spooner,1302007.1599999992,New Mexico,New York,2017-06-14
2403,HighMark LLC,CREDIT,853.02,2017-06-14,1,Maricruz Culver,1302860.1799999992,Maine,New York,2017-06-15
2404,HighMark LLC,CREDIT,4115.31,2017-06-14,1,William Deleon,1306975.4899999993,Mississippi,New York,2017-06-15
2405,HighMark LLC,CREDIT,1438.07,2017-06-14,1,Frank Tafel,1308413.5599999994,Finland,New York,2017-06-15
2406,HighMark LLC,CREDIT,546.03,2017-06-14,1,John Hill,1308959.5899999994,Pennsylvania,New York,2017-06-15
2407,HighMark LLC,CREDIT,1166.17,2017-06-14,1,Joanne Fortin,1310125.7599999993,South Carolina,New York,2017-06-15
2408,HighMark LLC,CREDIT,886.89,2017-06-14,1,Matthew Ciotti,1311012.6499999992,Hawaii,New York,2017-06-15
2409,HighMark LLC,CREDIT,4080.27,2017-06-14,1,Dulce Bustos,1315092.9199999992,Slovenia,New York,2017-06-15
1025,HighMark LLC,DEBIT,4705.96,2017-06-14,1,Richard Mendoza,1310386.9599999993,New York,Alaska,2017-06-15
2410,HighMark LLC,CREDIT,616.57,2017-06-15,1,Gabriela Hardaway,1311003.5299999993,Italy,New York,2017-06-16
2411,HighMark LLC,CREDIT,2674.62,2017-06-15,1,Joanne Fortin,1313678.1499999994,South Carolina,New York,2017-06-16
2412,HighMark LLC,CREDIT,313.33,2017-06-15,1,Loren Burgess,1313991.4799999995,Alabama,New York,2017-06-16
1029,HighMark LLC,DEBIT,10028.09,2017-06-15,1,Crystal Gibson,1303963.3899999994,New York,Colorado,2017-06-16
1030,HighMark LLC,DEBIT,4575.45,2017-06-15,1,William Biagioni,1299387.9399999995,New York,France,2017-06-16
2413,HighMark LLC,CREDIT,329.17,2017-06-15,1,John Nguyen,1299717.1099999994,Alaska,New York,2017-06-16
2414,HighMark LLC,CREDIT,640.91,2017-06-15,1,Katie Spooner,1300358.0199999993,New Mexico,New York,2017-06-16
2415,HighMark LLC,CREDIT,2795.38,2017-06-15,1,Lyle Laskowski,1303153.3999999992,Georgia,New York,2017-06-16
2416,HighMark LLC,CREDIT,479.77,2017-06-15,1,Christin Walker,1303633.1699999992,Arizona,New York,2017-06-16
2417,HighMark LLC,CREDIT,2864.13,2017-06-16,1,Christin Walker,1306497.299999999,Arizona,New York,2017-06-17
2418,HighMark LLC,CREDIT,1935.34,2017-06-16,1,Darius Sherrill,1308432.6399999992,Arkansas,New York,2017-06-17
2419,HighMark LLC,CREDIT,2834.5,2017-06-16,1,Georgeanna Debem,1311267.1399999992,Iowa,New York,2017-06-17
2420,HighMark LLC,CREDIT,1714.54,2017-06-16,1,Louis Nguyen,1312981.6799999992,Hungary,New York,2017-06-17
1039,HighMark LLC,DEBIT,3654.92,2017-06-16,1,Shane Stobb,1309326.7599999993,New York,Texas,2017-06-17
1040,HighMark LLC,DEBIT,8381.24,2017-06-16,1,James Moskal,1300945.5199999993,New York,Bulgaria,2017-06-17
2421,HighMark LLC,CREDIT,1122.77,2017-06-16,1,Edwin Highshaw,1302068.2899999993,Texas,New York,2017-06-17
2422,HighMark LLC,CREDIT,1549.5,2017-06-16,1,Edna Niese,1303617.7899999993,Virginia,New York,2017-06-17
2423,HighMark LLC,CREDIT,3233.48,2017-06-16,1,Sandy Newkirk,1306851.2699999993,Czech Republic,New York,2017-06-17
2424,HighMark LLC,CREDIT,1480.67,2017-06-17,1,Winford Landry,1308331.9399999992,Maine,New York,2017-06-18
2425,HighMark LLC,CREDIT,354.43,2017-06-17,1,Victoria Laramie,1308686.3699999992,Nebraska,New York,2017-06-18
2426,HighMark LLC,CREDIT,1469.72,2017-06-17,1,Matthew Ciotti,1310156.0899999992,Hawaii,New York,2017-06-18
2427,HighMark LLC,CREDIT,3091.62,2017-06-17,1,Jennifer Perez,1313247.7099999993,France,New York,2017-06-18
2428,HighMark LLC,CREDIT,472.31,2017-06-17,1,Katie Spooner,1313720.0199999993,New Mexico,New York,2017-06-18
2429,HighMark LLC,CREDIT,997.72,2017-06-17,1,William Stone,1314717.7399999993,Bulgaria,New York,2017-06-18
2430,HighMark LLC,CREDIT,2195.47,2017-06-17,1,Ann Rosa,1316913.2099999993,Indiana,New York,2017-06-18
2431,HighMark LLC,CREDIT,4274.17,2017-06-18,1,Lyle Laskowski,1321187.3799999992,Georgia,New York,2017-06-19
2432,HighMark LLC,CREDIT,1165.33,2017-06-18,1,Louis Nguyen,1322352.7099999993,Hungary,New York,2017-06-19
2433,HighMark LLC,CREDIT,3861.96,2017-06-18,1,Willie Robinson,1326214.6699999992,South Dakota,New York,2017-06-19
2434,HighMark LLC,CREDIT,1205.89,2017-06-18,1,Joanne Fortin,1327420.5599999991,South Carolina,New York,2017-06-19
2435,HighMark LLC,CREDIT,625.64,2017-06-18,1,Victoria Laramie,1328046.199999999,Nebraska,New York,2017-06-19
1056,HighMark LLC,DEBIT,5085.86,2017-06-18,1,Heather Young,1322960.339999999,New York,Bulgaria,2017-06-19
2436,HighMark LLC,CREDIT,1051.3,2017-06-19,1,Sarah Yates,1324011.639999999,Georgia,New York,2017-06-20
2437,HighMark LLC,CREDIT,3391.33,2017-06-19,1,Lois Collier,1327402.969999999,Estonia,New York,2017-06-20
2438,HighMark LLC,CREDIT,5763.58,2017-06-19,1,Winford Landry,1333166.549999999,Maine,New York,2017-06-20
2439,HighMark LLC,CREDIT,578.51,2017-06-19,1,Vanessa Carter,1333745.0599999991,Spain,New York,2017-06-20
2440,HighMark LLC,CREDIT,602.75,2017-06-19,1,Frankie Manners,1334347.8099999991,Oregon,New York,2017-06-20
2441,HighMark LLC,CREDIT,3463.33,2017-06-19,1,Osvaldo Porter,1337811.1399999992,Finland,New York,2017-06-20
2442,HighMark LLC,CREDIT,902.84,2017-06-19,1,Darius Sherrill,1338713.9799999993,Arkansas,New York,2017-06-20
2443,HighMark LLC,CREDIT,1184.93,2017-06-19,1,Ann Rosa,1339898.9099999992,Indiana,New York,2017-06-20
2444,HighMark LLC,CREDIT,1534.7,2017-06-19,1,Gabriela Hardaway,1341433.6099999992,Italy,New York,2017-06-20
1066,HighMark LLC,DEBIT,5185.98,2017-06-20,1,Ethan Young,1336247.6299999992,New York,Lithuania,2017-06-21
2445,HighMark LLC,CREDIT,1953.99,2017-06-20,1,Anthony Barnes,1338201.6199999992,Connecticut,New York,2017-06-21
2446,HighMark LLC,CREDIT,4859.59,2017-06-20,1,Jason Alves,1343061.2099999993,Wyoming,New York,2017-06-21
2447,HighMark LLC,CREDIT,361.83,2017-06-20,1,Bryan Mui,1343423.0399999993,Hawaii,New York,2017-06-21
2448,HighMark LLC,CREDIT,1375.17,2017-06-20,1,Angel Hirsch,1344798.2099999993,Pennsylvania,New York,2017-06-21
2449,HighMark LLC,CREDIT,4913.54,2017-06-20,1,Jennifer Perez,1349711.7499999993,France,New York,2017-06-21
2450,HighMark LLC,CREDIT,268.83,2017-06-20,1,Angela Harris,1349980.5799999994,Tennessee,New York,2017-06-21
2451,HighMark LLC,CREDIT,909.99,2017-06-20,1,Maricruz Culver,1350890.5699999994,Maine,New York,2017-06-21
2452,HighMark LLC,CREDIT,259.03,2017-06-20,1,Barbara Hazelrigg,1351149.5999999994,Romania,New York,2017-06-21
2453,HighMark LLC,CREDIT,2361.25,2017-06-20,1,Tammy Orozco,1353510.8499999994,Montana,New York,2017-06-21
2454,HighMark LLC,CREDIT,1629.29,2017-06-20,1,Mark Alexander,1355140.1399999994,Pennsylvania,New York,2017-06-21
2455,HighMark LLC,CREDIT,3586.15,2017-06-21,1,William Stone,1358726.2899999993,Bulgaria,New York,2017-06-22
2456,HighMark LLC,CREDIT,328.34,2017-06-21,1,Jennifer Perez,1359054.6299999994,France,New York,2017-06-22
2457,HighMark LLC,CREDIT,2010.77,2017-06-21,1,Warren Nobles,1361065.3999999994,Idaho,New York,2017-06-22
2458,HighMark LLC,CREDIT,280.22,2017-06-21,1,Angel Hirsch,1361345.6199999994,Pennsylvania,New York,2017-06-22
2459,HighMark LLC,CREDIT,1503.5,2017-06-21,1,Brenda Magnuson,1362849.1199999994,Austria,New York,2017-06-22
2460,HighMark LLC,CREDIT,1398.42,2017-06-21,1,Erica Toney,1364247.5399999993,Latvia,New York,2017-06-22
2461,HighMark LLC,CREDIT,2358.05,2017-06-21,1,Edna Jones,1366605.5899999994,Latvia,New York,2017-06-22
2462,HighMark LLC,CREDIT,2721.62,2017-06-21,1,Winford Landry,1369327.2099999995,Maine,New York,2017-06-22
2463,HighMark LLC,CREDIT,2396.96,2017-06-21,1,Randi Folger,1371724.1699999995,Maryland,New York,2017-06-22
2464,HighMark LLC,CREDIT,2803.83,2017-06-22,1,Daniel Walker,1374527.9999999995,South Carolina,New York,2017-06-23
2465,HighMark LLC,CREDIT,463.98,2017-06-22,1,Matthew Ciotti,1374991.9799999995,Hawaii,New York,2017-06-23
2466,HighMark LLC,CREDIT,3039.73,2017-06-22,1,Georgeanna Debem,1378031.7099999995,Iowa,New York,2017-06-23
2467,HighMark LLC,CREDIT,533.06,2017-06-22,1,Edna Niese,1378564.7699999996,Virginia,New York,2017-06-23
2468,HighMark LLC,CREDIT,2491.21,2017-06-22,1,Mike Pickerel,1381055.9799999995,North Dakota,New York,2017-06-23
2469,HighMark LLC,CREDIT,1457.66,2017-06-22,1,Ann Rosa,1382513.6399999994,Indiana,New York,2017-06-23
2470,HighMark LLC,CREDIT,1069.56,2017-06-22,1,Michael Rice,1383583.1999999995,Rhode Island,New York,2017-06-23
2471,HighMark LLC,CREDIT,645.33,2017-06-22,1,Agustin Bish,1384228.5299999996,Estonia,New York,2017-06-23
2472,HighMark LLC,CREDIT,2852.87,2017-06-23,1,Lois Collier,1387081.3999999997,Estonia,New York,2017-06-24
2473,HighMark LLC,CREDIT,1755.58,2017-06-23,1,Antonette Grace,1388836.9799999997,United Kingdom,New York,2017-06-24
2474,HighMark LLC,CREDIT,1225.08,2017-06-23,1,Connie Posey,1390062.0599999998,Wisconsin,New York,2017-06-24
2475,HighMark LLC,CREDIT,1810.42,2017-06-23,1,Anthony Smith,1391872.4799999997,Ireland,New York,2017-06-24
2476,HighMark LLC,CREDIT,726.14,2017-06-23,1,Christin Walker,1392598.6199999996,Arizona,New York,2017-06-24
2477,HighMark LLC,CREDIT,5989.12,2017-06-23,1,Laura Brant,1398587.7399999998,Iowa,New York,2017-06-24
2478,HighMark LLC,CREDIT,1783.95,2017-06-23,1,Matthew Ciotti,1400371.6899999997,Hawaii,New York,2017-06-24
2479,HighMark LLC,CREDIT,1316.22,2017-06-23,1,Vanessa Carter,1401687.9099999997,Spain,New York,2017-06-24
2480,HighMark LLC,CREDIT,3080.86,2017-06-23,1,Katie Spooner,1404768.7699999998,New Mexico,New York,2017-06-24
2481,HighMark LLC,CREDIT,728.25,2017-06-24,1,Ann Rosa,1405497.0199999998,Indiana,New York,2017-06-25
2482,HighMark LLC,CREDIT,1193.05,2017-06-24,1,Nancy Stutes,1406690.0699999998,Nebraska,New York,2017-06-25
2483,HighMark LLC,CREDIT,469.6,2017-06-24,1,Agustin Bish,1407159.67,Estonia,New York,2017-06-25
2484,HighMark LLC,CREDIT,3000.81,2017-06-24,1,Leon Birchler,1410160.48,Bulgaria,New York,2017-06-25
2485,HighMark LLC,CREDIT,978.24,2017-06-24,1,Danny Singh,1411138.72,Oklahoma,New York,2017-06-25
2486,HighMark LLC,CREDIT,1812.76,2017-06-24,1,Angel Hirsch,1412951.48,Pennsylvania,New York,2017-06-25
2487,HighMark LLC,CREDIT,965.25,2017-06-24,1,William Deleon,1413916.73,Mississippi,New York,2017-06-25
2488,HighMark LLC,CREDIT,2096.67,2017-06-24,1,Darius Sherrill,1416013.4,Arkansas,New York,2017-06-25
2489,HighMark LLC,CREDIT,2035.02,2017-06-24,1,Willie Robinson,1418048.42,South Dakota,New York,2017-06-25
2490,HighMark LLC,CREDIT,3306.96,2017-06-25,1,Edna Niese,1421355.38,Virginia,New York,2017-06-26
2491,HighMark LLC,CREDIT,1933.8,2017-06-25,1,Malka Cartwright,1423289.18,Alabama,New York,2017-06-26
2492,HighMark LLC,CREDIT,1570.05,2017-06-25,1,Glenda Coots,1424859.23,Lithuania,New York,2017-06-26
2493,HighMark LLC,CREDIT,4063.14,2017-06-25,1,Greg Hawkins,1428922.3699999999,North Carolina,New York,2017-06-26
2494,HighMark LLC,CREDIT,443.11,2017-06-25,1,Mae Gregory,1429365.48,Portugal,New York,2017-06-26
2495,HighMark LLC,CREDIT,2164.35,2017-06-26,1,Osvaldo Porter,1431529.83,Finland,New York,2017-06-27
2496,HighMark LLC,CREDIT,1889.27,2017-06-26,1,Nancy Stutes,1433419.1,Nebraska,New York,2017-06-27
2497,HighMark LLC,CREDIT,1405.56,2017-06-26,1,Cheryl Trilli,1434824.6600000001,Oregon,New York,2017-06-27
2498,HighMark LLC,CREDIT,5442.82,2017-06-26,1,Laura Brant,1440267.4800000002,Iowa,New York,2017-06-27
2499,HighMark LLC,CREDIT,286.21,2017-06-26,1,Jose Chaves,1440553.6900000002,New Jersey,New York,2017-06-27
2500,HighMark LLC,CREDIT,1936.78,2017-06-26,1,Brad Rose,1442490.4700000002,Rhode Island,New York,2017-06-27
2501,HighMark LLC,CREDIT,581.69,2017-06-26,1,Daniel Harrison,1443072.1600000001,Louisiana,New York,2017-06-27
2502,HighMark LLC,CREDIT,1332.07,2017-06-26,1,Jason Alves,1444404.2300000002,Wyoming,New York,2017-06-27
2503,HighMark LLC,CREDIT,3233.64,2017-06-26,1,John Nguyen,1447637.87,Alaska,New York,2017-06-27
2504,HighMark LLC,CREDIT,1480.16,2017-06-26,1,Susie Major,1449118.03,Kansas,New York,2017-06-27
2505,HighMark LLC,CREDIT,1168.64,2017-06-26,1,Lela Ames,1450286.67,Idaho,New York,2017-06-27
2506,HighMark LLC,CREDIT,4900.66,2017-06-27,1,John Ackerman,1455187.3299999998,Montana,New York,2017-06-28
2507,HighMark LLC,CREDIT,499.66,2017-06-27,1,Antonette Grace,1455686.9899999998,United Kingdom,New York,2017-06-28
2508,HighMark LLC,CREDIT,2748.71,2017-06-27,1,Daniel Walker,1458435.6999999997,South Carolina,New York,2017-06-28
2509,HighMark LLC,CREDIT,322.9,2017-06-27,1,Gabriela Hardaway,1458758.5999999996,Italy,New York,2017-06-28
1132,HighMark LLC,DEBIT,1887.37,2017-06-27,1,Adam Niles,1456871.2299999995,New York,California,2017-06-28
2510,HighMark LLC,CREDIT,1667.42,2017-06-27,1,Daniel Villeneuve,1458538.6499999994,South Dakota,New York,2017-06-28
2511,HighMark LLC,CREDIT,4255.6,2017-06-27,1,Victoria Laramie,1462794.2499999995,Nebraska,New York,2017-06-28
2512,HighMark LLC,CREDIT,1686.78,2017-06-27,1,Angel Hirsch,1464481.0299999996,Pennsylvania,New York,2017-06-28
2513,HighMark LLC,CREDIT,331.18,2017-06-27,1,Susie Major,1464812.2099999995,Kansas,New York,2017-06-28
2514,HighMark LLC,CREDIT,483.91,2017-06-28,1,Matthew Ciotti,1465296.1199999994,Hawaii,New York,2017-06-29
2515,HighMark LLC,CREDIT,3135.66,2017-06-28,1,Linda Henderson,1468431.7799999993,Italy,New York,2017-06-29
2516,HighMark LLC,CREDIT,1746.42,2017-06-28,1,Robert Dugger,1470178.1999999993,Slovenia,New York,2017-06-29
2517,HighMark LLC,CREDIT,3908.87,2017-06-28,1,Samuel Carswell,1474087.0699999994,Arkansas,New York,2017-06-29
2518,HighMark LLC,CREDIT,2447.72,2017-06-28,1,Greg Hawkins,1476534.7899999993,North Carolina,New York,2017-06-29
2519,HighMark LLC,CREDIT,1274.47,2017-06-28,1,Agustin Bish,1477809.2599999993,Estonia,New York,2017-06-29
2520,HighMark LLC,CREDIT,335.53,2017-06-28,1,Angel Hirsch,1478144.7899999993,Pennsylvania,New York,2017-06-29
2521,HighMark LLC,CREDIT,338.27,2017-06-28,1,William Stone,1478483.0599999994,Bulgaria,New York,2017-06-29
2522,HighMark LLC,CREDIT,483.84,2017-06-28,1,Jason Alves,1478966.8999999994,Wyoming,New York,2017-06-29
2523,HighMark LLC,CREDIT,1477.39,2017-06-28,1,Sandra Blair,1480444.2899999993,North Dakota,New York,2017-06-29
2524,HighMark LLC,CREDIT,2900.28,2017-06-28,1,Anthony Smith,1483344.5699999994,Ireland,New York,2017-06-29
2525,HighMark LLC,CREDIT,2769.68,2017-06-28,1,Brenda Magnuson,1486114.2499999993,Austria,New York,2017-06-29
2526,HighMark LLC,CREDIT,450.86,2017-06-29,1,Lois Snyder,1486565.1099999994,Illinois,New York,2017-06-30
2527,HighMark LLC,CREDIT,3367.83,2017-06-29,1,Susan Ware,1489932.9399999995,New York,New York,2017-06-30
2528,HighMark LLC,CREDIT,3530.77,2017-06-29,1,Daniel Harrison,1493463.7099999995,Louisiana,New York,2017-06-30
2529,HighMark LLC,CREDIT,974.8,2017-06-29,1,Gerald Marchant,1494438.5099999995,Idaho,New York,2017-06-30
2530,HighMark LLC,CREDIT,2620.98,2017-06-29,1,Connie Posey,1497059.4899999995,Wisconsin,New York,2017-06-30
2531,HighMark LLC,CREDIT,1832.83,2017-06-30,1,Anthony Smith,1498892.3199999996,Ireland,New York,2017-07-01
2532,HighMark LLC,CREDIT,840.05,2017-06-30,1,William Deleon,1499732.3699999996,Mississippi,New York,2017-07-01
2533,HighMark LLC,CREDIT,1101.21,2017-06-30,1,Linda Henderson,1500833.5799999996,Italy,New York,2017-07-01
2534,HighMark LLC,CREDIT,1006.97,2017-06-30,1,Christin Walker,1501840.5499999996,Arizona,New York,2017-07-01
2535,HighMark LLC,CREDIT,660.67,2017-06-30,1,John Nguyen,1502501.2199999995,Alaska,New York,2017-07-01
2536,HighMark LLC,CREDIT,2944.91,2017-06-30,1,Matthew Ciotti,1505446.1299999994,Hawaii,New York,2017-07-01
2537,HighMark LLC,CREDIT,1561.45,2017-06-30,1,Herbert Peevey,1507007.5799999994,Sweden,New York,2017-07-01
2538,HighMark LLC,CREDIT,1257.43,2017-06-30,1,Vanessa Carter,1508265.0099999993,Spain,New York,2017-07-01
2539,HighMark LLC,CREDIT,2670.3,2017-07-01,1,Brenda Magnuson,1510935.3099999994,Austria,New York,2017-07-02
2540,HighMark LLC,CREDIT,2489.0,2017-07-01,1,Erica Toney,1513424.3099999994,Latvia,New York,2017-07-02
2541,HighMark LLC,CREDIT,2340.2,2017-07-01,1,Paul Green,1515764.5099999993,Portugal,New York,2017-07-02
2542,HighMark LLC,CREDIT,855.78,2017-07-01,1,Ann Rosa,1516620.2899999993,Indiana,New York,2017-07-02
2543,HighMark LLC,CREDIT,1387.89,2017-07-01,1,Nancy Stutes,1518008.1799999992,Nebraska,New York,2017-07-02
2544,HighMark LLC,CREDIT,955.35,2017-07-01,1,Jennifer Perez,1518963.5299999993,France,New York,2017-07-02
2545,HighMark LLC,CREDIT,406.07,2017-07-01,1,Amy Garland,1519369.5999999994,Slovenia,New York,2017-07-02
2546,HighMark LLC,CREDIT,2313.52,2017-07-02,1,Leon Birchler,1521683.1199999994,Bulgaria,New York,2017-07-03
2547,HighMark LLC,CREDIT,688.77,2017-07-02,1,Daniel Harrison,1522371.8899999994,Louisiana,New York,2017-07-03
2548,HighMark LLC,CREDIT,2821.36,2017-07-02,1,Katie Spooner,1525193.2499999995,New Mexico,New York,2017-07-03
2549,HighMark LLC,CREDIT,3966.94,2017-07-02,1,James Cole,1529160.1899999995,Wyoming,New York,2017-07-03
2550,HighMark LLC,CREDIT,408.25,2017-07-02,1,John Nguyen,1529568.4399999995,Alaska,New York,2017-07-03
2551,HighMark LLC,CREDIT,413.6,2017-07-03,1,Samuel Carswell,1529982.0399999996,Arkansas,New York,2017-07-04
2552,HighMark LLC,CREDIT,1265.29,2017-07-03,1,Willie Robinson,1531247.3299999996,South Dakota,New York,2017-07-04
1176,HighMark LLC,DEBIT,7323.14,2017-07-03,1,Reinaldo Landeros,1523924.1899999997,New York,Utah,2017-07-04
2553,HighMark LLC,CREDIT,463.16,2017-07-04,1,Anthony Smith,1524387.3499999996,Ireland,New York,2017-07-05
2554,HighMark LLC,CREDIT,2693.86,2017-07-04,1,Edwin Highshaw,1527081.2099999997,Texas,New York,2017-07-05
2555,HighMark LLC,CREDIT,1882.29,2017-07-04,1,Sofia Pinkerton,1528963.4999999998,Arkansas,New York,2017-07-05
2556,HighMark LLC,CREDIT,942.02,2017-07-04,1,Paul Green,1529905.5199999998,Portugal,New York,2017-07-05
2557,HighMark LLC,CREDIT,479.73,2017-07-04,1,Jennifer Oday,1530385.2499999998,North Dakota,New York,2017-07-05
1182,HighMark LLC,DEBIT,8945.07,2017-07-04,1,Charles Hutchison,1521440.1799999997,New York,Spain,2017-07-05
1183,HighMark LLC,DEBIT,2045.42,2017-07-04,1,Lillian Lawyer,1519394.7599999998,New York,Oklahoma,2017-07-05
2558,HighMark LLC,CREDIT,333.33,2017-07-05,1,Gabriela Hardaway,1519728.0899999999,Italy,New York,2017-07-06
2559,HighMark LLC,CREDIT,2458.56,2017-07-05,1,Susan Ware,1522186.65,New York,New York,2017-07-06
2560,HighMark LLC,CREDIT,1734.63,2017-07-05,1,Sofia Pinkerton,1523921.2799999998,Arkansas,New York,2017-07-06
1187,HighMark LLC,DEBIT,1924.6,2017-07-05,1,Lillian Lawyer,1521996.6799999997,New York,Oklahoma,2017-07-06
2561,HighMark LLC,CREDIT,3025.72,2017-07-05,1,Catherine Kleine,1525022.3999999997,Maryland,New York,2017-07-06
2562,HighMark LLC,CREDIT,584.69,2017-07-05,1,Melody Blakey,1525607.0899999996,Slovakia,New York,2017-07-06
2563,HighMark LLC,CREDIT,428.2,2017-07-05,1,Edwin Highshaw,1526035.2899999996,Texas,New York,2017-07-06
2564,HighMark LLC,CREDIT,2294.87,2017-07-05,1,Greg Hawkins,1528330.1599999997,North Carolina,New York,2017-07-06
2565,HighMark LLC,CREDIT,267.52,2017-07-05,1,Ronald Mills,1528597.6799999997,Netherlands,New York,2017-07-06
2566,HighMark LLC,CREDIT,5176.85,2017-07-05,1,Lyle Laskowski,1533774.5299999998,Georgia,New York,2017-07-06
2567,HighMark LLC,CREDIT,3862.23,2017-07-06,1,Warren Nobles,1537636.7599999998,Idaho,New York,2017-07-07
2568,HighMark LLC,CREDIT,2099.94,2017-07-06,1,Jennifer Perez,1539736.6999999997,France,New York,2017-07-07
2569,HighMark LLC,CREDIT,2346.13,2017-07-06,1,Susie Major,1542082.8299999996,Kansas,New York,2017-07-07
2570,HighMark LLC,CREDIT,2948.6,2017-07-06,1,James Cole,1545031.4299999997,Wyoming,New York,2017-07-07
2571,HighMark LLC,CREDIT,594.4,2017-07-07,1,John Hill,1545625.8299999996,Pennsylvania,New York,2017-07-08
2572,HighMark LLC,CREDIT,1944.3,2017-07-07,1,Leon Birchler,1547570.1299999997,Bulgaria,New York,2017-07-08
2573,HighMark LLC,CREDIT,3898.08,2017-07-07,1,Donald Weber,1551468.2099999997,Georgia,New York,2017-07-08
2574,HighMark LLC,CREDIT,502.19,2017-07-07,1,Erica Toney,1551970.3999999997,Latvia,New York,2017-07-08
2575,HighMark LLC,CREDIT,1259.79,2017-07-07,1,Glenda Coots,1553230.1899999997,Lithuania,New York,2017-07-08
2576,HighMark LLC,CREDIT,2442.98,2017-07-07,1,Susan Ware,1555673.1699999997,New York,New York,2017-07-08
2577,HighMark LLC,CREDIT,1682.13,2017-07-08,1,Bill Wagner,1557355.2999999996,Portugal,New York,2017-07-09
2578,HighMark LLC,CREDIT,2362.15,2017-07-08,1,Antonette Grace,1559717.4499999995,United Kingdom,New York,2017-07-09
2579,HighMark LLC,CREDIT,1128.03,2017-07-08,1,Linda Henderson,1560845.4799999995,Italy,New York,2017-07-09
2580,HighMark LLC,CREDIT,2685.27,2017-07-08,1,Ann Rosa,1563530.7499999995,Indiana,New York,2017-07-09
2581,HighMark LLC,CREDIT,728.63,2017-07-08,1,Gabriela Hardaway,1564259.3799999994,Italy,New York,2017-07-09
2582,HighMark LLC,CREDIT,1028.11,2017-07-08,1,Daniel Walker,1565287.4899999995,South Carolina,New York,2017-07-09
2583,HighMark LLC,CREDIT,2586.0,2017-07-09,1,Vanessa Carter,1567873.4899999995,Spain,New York,2017-07-10
2584,HighMark LLC,CREDIT,880.47,2017-07-09,1,Matthew Ciotti,1568753.9599999995,Hawaii,New York,2017-07-10
2585,HighMark LLC,CREDIT,876.93,2017-07-09,1,Brad Rose,1569630.8899999994,Rhode Island,New York,2017-07-10
2586,HighMark LLC,CREDIT,523.41,2017-07-09,1,Thomas Read,1570154.2999999993,Arkansas,New York,2017-07-10
2587,HighMark LLC,CREDIT,2029.88,2017-07-09,1,Barbara Hazelrigg,1572184.1799999992,Romania,New York,2017-07-10
2588,HighMark LLC,CREDIT,2440.22,2017-07-09,1,Carrie Morrison,1574624.3999999992,Belgium,New York,2017-07-10
2589,HighMark LLC,CREDIT,1706.05,2017-07-09,1,Bill Wagner,1576330.4499999993,Portugal,New York,2017-07-10
2590,HighMark LLC,CREDIT,5322.56,2017-07-09,1,Laura Brant,1581653.0099999993,Iowa,New York,2017-07-10
2591,HighMark LLC,CREDIT,2570.76,2017-07-09,1,Victoria Laramie,1584223.7699999993,Nebraska,New York,2017-07-10
2592,HighMark LLC,CREDIT,513.8,2017-07-09,1,Brenda Magnuson,1584737.5699999994,Austria,New York,2017-07-10
2593,HighMark LLC,CREDIT,797.06,2017-07-10,1,James Cole,1585534.6299999994,Wyoming,New York,2017-07-11
2594,HighMark LLC,CREDIT,3320.52,2017-07-10,1,Connie Posey,1588855.1499999994,Wisconsin,New York,2017-07-11
2595,HighMark LLC,CREDIT,1076.62,2017-07-10,1,John Hill,1589931.7699999996,Pennsylvania,New York,2017-07-11
2596,HighMark LLC,CREDIT,587.2,2017-07-10,1,Angel Hirsch,1590518.9699999995,Pennsylvania,New York,2017-07-11
1224,HighMark LLC,DEBIT,4078.53,2017-07-10,1,Niki Bridges,1586440.4399999995,New York,North Dakota,2017-07-11
2597,HighMark LLC,CREDIT,1004.16,2017-07-11,1,Aaron Parker,1587444.5999999994,Alabama,New York,2017-07-12
2598,HighMark LLC,CREDIT,915.65,2017-07-11,1,Sarah Yates,1588360.2499999993,Georgia,New York,2017-07-12
2599,HighMark LLC,CREDIT,254.98,2017-07-11,1,Winford Landry,1588615.2299999993,Maine,New York,2017-07-12
2600,HighMark LLC,CREDIT,1227.33,2017-07-11,1,Randi Folger,1589842.5599999994,Maryland,New York,2017-07-12
2601,HighMark LLC,CREDIT,1412.09,2017-07-11,1,Lois Collier,1591254.6499999994,Estonia,New York,2017-07-12
2602,HighMark LLC,CREDIT,2149.57,2017-07-11,1,Carrie Morrison,1593404.2199999995,Belgium,New York,2017-07-12
2603,HighMark LLC,CREDIT,2653.85,2017-07-11,1,Cheryl Trilli,1596058.0699999996,Oregon,New York,2017-07-12
2604,HighMark LLC,CREDIT,972.6,2017-07-11,1,Leon Birchler,1597030.6699999997,Bulgaria,New York,2017-07-12
2605,HighMark LLC,CREDIT,750.76,2017-07-12,1,Daniel Walker,1597781.4299999997,South Carolina,New York,2017-07-13
1234,HighMark LLC,DEBIT,7956.34,2017-07-12,1,Gwendolyn Morrison,1589825.0899999996,New York,Maryland,2017-07-13
2606,HighMark LLC,CREDIT,1135.2,2017-07-12,1,Gerald Alarcon,1590960.2899999996,Belgium,New York,2017-07-13
2607,HighMark LLC,CREDIT,704.67,2017-07-12,1,Thomas Read,1591664.9599999995,Arkansas,New York,2017-07-13
2608,HighMark LLC,CREDIT,1915.38,2017-07-12,1,Linda Henderson,1593580.3399999994,Italy,New York,2017-07-13
2609,HighMark LLC,CREDIT,877.36,2017-07-12,1,Amy Garland,1594457.6999999995,Slovenia,New York,2017-07-13
2610,HighMark LLC,CREDIT,4457.19,2017-07-12,1,Barbara Bale,1598914.8899999994,Michigan,New York,2017-07-13
2611,HighMark LLC,CREDIT,432.33,2017-07-12,1,Beth Bruno,1599347.2199999995,Ohio,New York,2017-07-13
2612,HighMark LLC,CREDIT,1273.73,2017-07-12,1,Cheryl Trilli,1600620.9499999995,Oregon,New York,2017-07-13
2613,HighMark LLC,CREDIT,879.55,2017-07-13,1,Robert Dugger,1601500.4999999995,Slovenia,New York,2017-07-14
2614,HighMark LLC,CREDIT,1538.71,2017-07-13,1,Thomas Read,1603039.2099999995,Arkansas,New York,2017-07-14
2615,HighMark LLC,CREDIT,1575.14,2017-07-13,1,Sandy Newkirk,1604614.3499999994,Czech Republic,New York,2017-07-14
2616,HighMark LLC,CREDIT,1437.48,2017-07-13,1,Brad Rose,1606051.8299999994,Rhode Island,New York,2017-07-14
2617,HighMark LLC,CREDIT,470.23,2017-07-13,1,Warren Nobles,1606522.0599999994,Idaho,New York,2017-07-14
2618,HighMark LLC,CREDIT,2213.12,2017-07-13,1,Laura Brant,1608735.1799999995,Iowa,New York,2017-07-14
2619,HighMark LLC,CREDIT,1230.79,2017-07-13,1,Georgeanna Debem,1609965.9699999995,Iowa,New York,2017-07-14
2620,HighMark LLC,CREDIT,1233.47,2017-07-13,1,Stan Tannenbaum,1611199.4399999995,Rhode Island,New York,2017-07-14
2621,HighMark LLC,CREDIT,469.01,2017-07-13,1,Angel Hirsch,1611668.4499999995,Pennsylvania,New York,2017-07-14
1251,HighMark LLC,DEBIT,3939.79,2017-07-13,1,Shannon Lazor,1607728.6599999995,New York,Alabama,2017-07-14
2622,HighMark LLC,CREDIT,1891.14,2017-07-13,1,Amy Garland,1609619.7999999993,Slovenia,New York,2017-07-14
2623,HighMark LLC,CREDIT,1740.7,2017-07-14,1,James Cole,1611360.4999999993,Wyoming,New York,2017-07-15
2624,HighMark LLC,CREDIT,2334.05,2017-07-14,1,Julio Mccabe,1613694.5499999993,Wisconsin,New York,2017-07-15
2625,HighMark LLC,CREDIT,2332.54,2017-07-14,1,Jose Chaves,1616027.0899999994,New Jersey,New York,2017-07-15
2626,HighMark LLC,CREDIT,835.33,2017-07-14,1,Ronald Mills,1616862.4199999995,Netherlands,New York,2017-07-15
2627,HighMark LLC,CREDIT,2030.1,2017-07-14,1,Loren Burgess,1618892.5199999996,Alabama,New York,2017-07-15
2628,HighMark LLC,CREDIT,619.63,2017-07-14,1,Barbara Bale,1619512.1499999994,Michigan,New York,2017-07-15
2629,HighMark LLC,CREDIT,2169.53,2017-07-14,1,John Hill,1621681.6799999995,Pennsylvania,New York,2017-07-15
2630,HighMark LLC,CREDIT,278.67,2017-07-14,1,Jason Alves,1621960.3499999994,Wyoming,New York,2017-07-15
2631,HighMark LLC,CREDIT,2986.37,2017-07-15,1,Joanne Fortin,1624946.7199999995,South Carolina,New York,2017-07-16
2632,HighMark LLC,CREDIT,3484.38,2017-07-15,1,Lela Ames,1628431.0999999994,Idaho,New York,2017-07-16
2633,HighMark LLC,CREDIT,1920.83,2017-07-15,1,Jennifer Perez,1630351.9299999995,France,New York,2017-07-16
2634,HighMark LLC,CREDIT,950.92,2017-07-15,1,Anthony Smith,1631302.8499999994,Ireland,New York,2017-07-16
2635,HighMark LLC,CREDIT,5773.28,2017-07-15,1,Warren Nobles,1637076.1299999994,Idaho,New York,2017-07-16
2636,HighMark LLC,CREDIT,1565.0,2017-07-15,1,Mike Pickerel,1638641.1299999994,North Dakota,New York,2017-07-16
2637,HighMark LLC,CREDIT,2630.49,2017-07-15,1,Vanessa Carter,1641271.6199999994,Spain,New York,2017-07-16
2638,HighMark LLC,CREDIT,427.16,2017-07-15,1,Christin Walker,1641698.7799999993,Arizona,New York,2017-07-16
2639,HighMark LLC,CREDIT,1370.53,2017-07-16,1,Dulce Bustos,1643069.3099999994,Slovenia,New York,2017-07-17
2640,HighMark LLC,CREDIT,2550.31,2017-07-16,1,Robert Dugger,1645619.6199999994,Slovenia,New York,2017-07-17
2641,HighMark LLC,CREDIT,1457.38,2017-07-16,1,John Nguyen,1647076.9999999993,Alaska,New York,2017-07-17
2642,HighMark LLC,CREDIT,1524.06,2017-07-16,1,Donald Weber,1648601.0599999994,Georgia,New York,2017-07-17
1273,HighMark LLC,DEBIT,2417.36,2017-07-16,1,Renee Holden,1646183.6999999993,New York,Oklahoma,2017-07-17
2643,HighMark LLC,CREDIT,3412.6,2017-07-17,1,Georgeanna Debem,1649596.2999999993,Iowa,New York,2017-07-18
2644,HighMark LLC,CREDIT,1054.62,2017-07-17,1,John Hill,1650650.9199999995,Pennsylvania,New York,2017-07-18
2645,HighMark LLC,CREDIT,1612.67,2017-07-17,1,Angel Hirsch,1652263.5899999994,Pennsylvania,New York,2017-07-18
2646,HighMark LLC,CREDIT,3277.29,2017-07-17,1,Lela Ames,1655540.8799999994,Idaho,New York,2017-07-18
2647,HighMark LLC,CREDIT,2167.78,2017-07-17,1,Donald Weber,1657708.6599999995,Georgia,New York,2017-07-18
2648,HighMark LLC,CREDIT,1014.48,2017-07-17,1,Edwin Highshaw,1658723.1399999994,Texas,New York,2017-07-18
2649,HighMark LLC,CREDIT,2247.03,2017-07-18,1,Daniel Harrison,1660970.1699999995,Louisiana,New York,2017-07-19
2650,HighMark LLC,CREDIT,2531.92,2017-07-18,1,Victoria Laramie,1663502.0899999994,Nebraska,New York,2017-07-19
2651,HighMark LLC,CREDIT,1419.16,2017-07-18,1,Robert Dugger,1664921.2499999993,Slovenia,New York,2017-07-19
2652,HighMark LLC,CREDIT,1015.84,2017-07-18,1,Ann Rosa,1665937.0899999994,Indiana,New York,2017-07-19
1284,HighMark LLC,DEBIT,6953.88,2017-07-18,1,Ralph Palmer,1658983.2099999995,New York,Wisconsin,2017-07-19
2653,HighMark LLC,CREDIT,383.86,2017-07-18,1,Angela Harris,1659367.0699999996,Tennessee,New York,2017-07-19
2654,HighMark LLC,CREDIT,4086.54,2017-07-18,1,Anthony Barnes,1663453.6099999996,Connecticut,New York,2017-07-19
2655,HighMark LLC,CREDIT,2372.0,2017-07-18,1,Osvaldo Porter,1665825.6099999996,Finland,New York,2017-07-19
2656,HighMark LLC,CREDIT,3770.58,2017-07-19,1,Mae Gregory,1669596.1899999997,Portugal,New York,2017-07-20
2657,HighMark LLC,CREDIT,3937.99,2017-07-19,1,Daniel Harrison,1673534.1799999997,Louisiana,New York,2017-07-20
2658,HighMark LLC,CREDIT,805.77,2017-07-19,1,Matthew Ciotti,1674339.9499999997,Hawaii,New York,2017-07-20
2659,HighMark LLC,CREDIT,3110.77,2017-07-19,1,Bryan Mui,1677450.7199999997,Hawaii,New York,2017-07-20
2660,HighMark LLC,CREDIT,2438.67,2017-07-19,1,John Hill,1679889.3899999997,Pennsylvania,New York,2017-07-20
2661,HighMark LLC,CREDIT,4160.27,2017-07-19,1,Amy Garland,1684049.6599999997,Slovenia,New York,2017-07-20
2662,HighMark LLC,CREDIT,5513.94,2017-07-19,1,Angel Hirsch,1689563.5999999996,Pennsylvania,New York,2017-07-20
2663,HighMark LLC,CREDIT,1815.55,2017-07-19,1,Anthony Smith,1691379.1499999997,Ireland,New York,2017-07-20
2664,HighMark LLC,CREDIT,829.48,2017-07-19,1,Agustin Bish,1692208.6299999997,Estonia,New York,2017-07-20
1297,HighMark LLC,DEBIT,2190.07,2017-07-20,1,Earl Rodriguez,1690018.5599999996,New York,North Dakota,2017-07-21
2665,HighMark LLC,CREDIT,2090.23,2017-07-20,1,Greg Hawkins,1692108.7899999996,North Carolina,New York,2017-07-21
2666,HighMark LLC,CREDIT,1186.97,2017-07-20,1,Willie Robinson,1693295.7599999995,South Dakota,New York,2017-07-21
2667,HighMark LLC,CREDIT,1130.27,2017-07-20,1,Jason Alves,1694426.0299999996,Wyoming,New York,2017-07-21
2668,HighMark LLC,CREDIT,966.74,2017-07-20,1,Lois Collier,1695392.7699999996,Estonia,New York,2017-07-21
2669,HighMark LLC,CREDIT,599.46,2017-07-20,1,Maricruz Culver,1695992.2299999995,Maine,New York,2017-07-21
2670,HighMark LLC,CREDIT,1173.6,2017-07-21,1,John Nguyen,1697165.8299999996,Alaska,New York,2017-07-22
2671,HighMark LLC,CREDIT,1210.73,2017-07-21,1,Thomas Jones,1698376.5599999996,Slovenia,New York,2017-07-22
2672,HighMark LLC,CREDIT,3342.36,2017-07-21,1,Danny Singh,1701718.9199999997,Oklahoma,New York,2017-07-22
2673,HighMark LLC,CREDIT,6059.72,2017-07-21,1,Jennifer Oday,1707778.6399999997,North Dakota,New York,2017-07-22
2674,HighMark LLC,CREDIT,318.74,2017-07-21,1,Lois Snyder,1708097.3799999997,Illinois,New York,2017-07-22
2675,HighMark LLC,CREDIT,971.56,2017-07-21,1,Sandy Newkirk,1709068.9399999997,Czech Republic,New York,2017-07-22
2676,HighMark LLC,CREDIT,2800.66,2017-07-21,1,Bryan Mui,1711869.5999999996,Hawaii,New York,2017-07-22
2677,HighMark LLC,CREDIT,394.42,2017-07-21,1,Warren Nobles,1712264.0199999996,Idaho,New York,2017-07-22
2678,HighMark LLC,CREDIT,1966.54,2017-07-21,1,Jose Chaves,1714230.5599999996,New Jersey,New York,2017-07-22
1312,HighMark LLC,DEBIT,12406.82,2017-07-21,1,John Barnhart,1701823.7399999995,New York,India,2017-07-22
2679,HighMark LLC,CREDIT,1655.85,2017-07-21,1,Cheryl Trilli,1703479.5899999996,Oregon,New York,2017-07-22
2680,HighMark LLC,CREDIT,4432.11,2017-07-21,1,Edna Niese,1707911.6999999997,Virginia,New York,2017-07-22
2681,HighMark LLC,CREDIT,3045.55,2017-07-21,1,James Cole,1710957.2499999998,Wyoming,New York,2017-07-22
2682,HighMark LLC,CREDIT,1327.94,2017-07-22,1,Mark Alexander,1712285.1899999997,Pennsylvania,New York,2017-07-23
2683,HighMark LLC,CREDIT,429.4,2017-07-22,1,Bryan Mui,1712714.5899999996,Hawaii,New York,2017-07-23
2684,HighMark LLC,CREDIT,1845.22,2017-07-22,1,Osvaldo Porter,1714559.8099999996,Finland,New York,2017-07-23
2685,HighMark LLC,CREDIT,2091.21,2017-07-22,1,Laura Brant,1716651.0199999996,Iowa,New York,2017-07-23
1320,HighMark LLC,DEBIT,7632.91,2017-07-22,1,John Barnhart,1709018.1099999996,New York,India,2017-07-23
2686,HighMark LLC,CREDIT,3038.47,2017-07-22,1,Mike Pickerel,1712056.5799999996,North Dakota,New York,2017-07-23
2687,HighMark LLC,CREDIT,522.39,2017-07-22,1,Anthony Barnes,1712578.9699999995,Connecticut,New York,2017-07-23
2688,HighMark LLC,CREDIT,305.62,2017-07-22,1,Cheryl Trilli,1712884.5899999996,Oregon,New York,2017-07-23
2689,HighMark LLC,CREDIT,964.56,2017-07-23,1,Frankie Manners,1713849.1499999997,Oregon,New York,2017-07-24
2690,HighMark LLC,CREDIT,433.63,2017-07-23,1,James Cole,1714282.7799999996,Wyoming,New York,2017-07-24
2691,HighMark LLC,CREDIT,1100.42,2017-07-23,1,Barbara Bale,1715383.1999999995,Michigan,New York,2017-07-24
2692,HighMark LLC,CREDIT,587.52,2017-07-23,1,Nancy Stutes,1715970.7199999995,Nebraska,New York,2017-07-24
2693,HighMark LLC,CREDIT,2166.07,2017-07-23,1,Maricruz Culver,1718136.7899999996,Maine,New York,2017-07-24
2694,HighMark LLC,CREDIT,3894.91,2017-07-24,1,John Ackerman,1722031.6999999995,Montana,New York,2017-07-25
2695,HighMark LLC,CREDIT,581.97,2017-07-24,1,Loren Burgess,1722613.6699999995,Alabama,New York,2017-07-25
2696,HighMark LLC,CREDIT,1781.87,2017-07-24,1,Willie Robinson,1724395.5399999996,South Dakota,New York,2017-07-25
2697,HighMark LLC,CREDIT,1688.6,2017-07-24,1,Brenda Magnuson,1726084.1399999997,Austria,New York,2017-07-25
2698,HighMark LLC,CREDIT,1300.67,2017-07-24,1,John Hill,1727384.8099999996,Pennsylvania,New York,2017-07-25
2699,HighMark LLC,CREDIT,491.13,2017-07-24,1,Louis Nguyen,1727875.9399999995,Hungary,New York,2017-07-25
1335,HighMark LLC,DEBIT,5984.13,2017-07-24,1,Ophelia Ramirez,1721891.8099999996,New York,Rhode Island,2017-07-25
2700,HighMark LLC,CREDIT,1066.77,2017-07-24,1,Sofia Pinkerton,1722958.5799999996,Arkansas,New York,2017-07-25
2701,HighMark LLC,CREDIT,2019.29,2017-07-24,1,Christin Walker,1724977.8699999996,Arizona,New York,2017-07-25
2702,HighMark LLC,CREDIT,2843.12,2017-07-24,1,William Stone,1727820.9899999998,Bulgaria,New York,2017-07-25
2703,HighMark LLC,CREDIT,2341.83,2017-07-24,1,Daniel Walker,1730162.8199999998,South Carolina,New York,2017-07-25
2704,HighMark LLC,CREDIT,2009.93,2017-07-24,1,Warren Nobles,1732172.7499999998,Idaho,New York,2017-07-25
1341,HighMark LLC,DEBIT,1811.11,2017-07-25,1,Arthur Davine,1730361.6399999997,New York,Italy,2017-07-26
2705,HighMark LLC,CREDIT,1818.1,2017-07-25,1,Randi Folger,1732179.7399999998,Maryland,New York,2017-07-26
2706,HighMark LLC,CREDIT,2311.57,2017-07-25,1,Edwin Highshaw,1734491.3099999998,Texas,New York,2017-07-26
2707,HighMark LLC,CREDIT,323.64,2017-07-25,1,Ann Rosa,1734814.9499999997,Indiana,New York,2017-07-26
2708,HighMark LLC,CREDIT,2586.7,2017-07-25,1,Warren Nobles,1737401.6499999997,Idaho,New York,2017-07-26
2709,HighMark LLC,CREDIT,1173.74,2017-07-25,1,Leon Birchler,1738575.3899999997,Bulgaria,New York,2017-07-26
2710,HighMark LLC,CREDIT,2811.13,2017-07-25,1,Willie Robinson,1741386.5199999996,South Dakota,New York,2017-07-26
2711,HighMark LLC,CREDIT,746.06,2017-07-25,1,Ronald Mills,1742132.5799999996,Netherlands,New York,2017-07-26
2712,HighMark LLC,CREDIT,2479.32,2017-07-26,1,Thomas Jones,1744611.8999999997,Slovenia,New York,2017-07-27
2713,HighMark LLC,CREDIT,1188.63,2017-07-26,1,Michael Rice,1745800.5299999996,Rhode Island,New York,2017-07-27
2714,HighMark LLC,CREDIT,302.77,2017-07-26,1,Jose Chaves,1746103.2999999996,New Jersey,New York,2017-07-27
2715,HighMark LLC,CREDIT,1380.34,2017-07-26,1,Greg Hawkins,1747483.6399999997,North Carolina,New York,2017-07-27
2716,HighMark LLC,CREDIT,3175.55,2017-07-26,1,Barbara Bale,1750659.1899999997,Michigan,New York,2017-07-27
2717,HighMark LLC,CREDIT,677.06,2017-07-26,1,Lois Snyder,1751336.2499999998,Illinois,New York,2017-07-27
2718,HighMark LLC,CREDIT,485.36,2017-07-26,1,John Nguyen,1751821.6099999999,Alaska,New York,2017-07-27
2719,HighMark LLC,CREDIT,469.59,2017-07-26,1,Robert Dugger,1752291.2,Slovenia,New York,2017-07-27
2720,HighMark LLC,CREDIT,439.44,2017-07-27,1,Danny Singh,1752730.64,Oklahoma,New York,2017-07-28
2721,HighMark LLC,CREDIT,352.83,2017-07-27,1,Gabriela Hardaway,1753083.47,Italy,New York,2017-07-28
2722,HighMark LLC,CREDIT,637.4,2017-07-27,1,Scott Anzalone,1753720.8699999999,New York,New York,2017-07-28
2723,HighMark LLC,CREDIT,646.9,2017-07-27,1,John Ackerman,1754367.7699999998,Montana,New York,2017-07-28
2724,HighMark LLC,CREDIT,2210.76,2017-07-27,1,Lois Snyder,1756578.5299999998,Illinois,New York,2017-07-28
2725,HighMark LLC,CREDIT,922.25,2017-07-27,1,Herbert Peevey,1757500.7799999998,Sweden,New York,2017-07-28
1363,HighMark LLC,DEBIT,10651.58,2017-07-27,1,John Barnhart,1746849.1999999997,New York,India,2017-07-28
2726,HighMark LLC,CREDIT,3832.0,2017-07-28,1,Gerald Alarcon,1750681.1999999997,Belgium,New York,2017-07-29
2727,HighMark LLC,CREDIT,3185.45,2017-07-28,1,Gabriela Hardaway,1753866.6499999997,Italy,New York,2017-07-29
2728,HighMark LLC,CREDIT,1311.77,2017-07-28,1,Brenda Magnuson,1755178.4199999997,Austria,New York,2017-07-29
2729,HighMark LLC,CREDIT,690.07,2017-07-28,1,Nancy Stutes,1755868.4899999998,Nebraska,New York,2017-07-29
2730,HighMark LLC,CREDIT,300.44,2017-07-28,1,Jason Alves,1756168.9299999997,Wyoming,New York,2017-07-29
2731,HighMark LLC,CREDIT,1028.42,2017-07-28,1,Lucius Majure,1757197.3499999996,Wyoming,New York,2017-07-29
1370,HighMark LLC,DEBIT,4477.59,2017-07-28,1,Cody Bennett,1752719.7599999995,New York,Croatia,2017-07-29
2732,HighMark LLC,CREDIT,329.56,2017-07-28,1,Vanessa Carter,1753049.3199999996,Spain,New York,2017-07-29
2733,HighMark LLC,CREDIT,1566.87,2017-07-28,1,Louis Nguyen,1754616.1899999997,Hungary,New York,2017-07-29
2734,HighMark LLC,CREDIT,931.23,2017-07-28,1,Michael Rice,1755547.4199999997,Rhode Island,New York,2017-07-29
2735,HighMark LLC,CREDIT,2286.46,2017-07-28,1,Christin Walker,1757833.8799999997,Arizona,New York,2017-07-29
2736,HighMark LLC,CREDIT,1922.17,2017-07-29,1,Lela Ames,1759756.0499999996,Idaho,New York,2017-07-30
2737,HighMark LLC,CREDIT,1621.54,2017-07-29,1,Christin Walker,1761377.5899999996,Arizona,New York,2017-07-30
2738,HighMark LLC,CREDIT,3639.83,2017-07-29,1,Daniel Harrison,1765017.4199999997,Louisiana,New York,2017-07-30
2739,HighMark LLC,CREDIT,2874.69,2017-07-29,1,Jennifer Perez,1767892.1099999996,France,New York,2017-07-30
2740,HighMark LLC,CREDIT,423.48,2017-07-29,1,Herbert Peevey,1768315.5899999996,Sweden,New York,2017-07-30
2741,HighMark LLC,CREDIT,1225.25,2017-07-29,1,Edna Niese,1769540.8399999996,Virginia,New York,2017-07-30
2742,HighMark LLC,CREDIT,3511.88,2017-07-29,1,Katie Spooner,1773052.7199999995,New Mexico,New York,2017-07-30
2743,HighMark LLC,CREDIT,1026.2,2017-07-29,1,Michael Rice,1774078.9199999995,Rhode Island,New York,2017-07-30
2744,HighMark LLC,CREDIT,3327.48,2017-07-29,1,Sandy Newkirk,1777406.3999999994,Czech Republic,New York,2017-07-30
2745,HighMark LLC,CREDIT,1092.34,2017-07-29,1,Melody Blakey,1778498.7399999995,Slovakia,New York,2017-07-30
2746,HighMark LLC,CREDIT,1302.49,2017-07-30,1,Nancy Stutes,1779801.2299999995,Nebraska,New York,2017-07-31
2747,HighMark LLC,CREDIT,1355.66,2017-07-30,1,Maricruz Culver,1781156.8899999994,Maine,New York,2017-07-31
2748,HighMark LLC,CREDIT,1596.57,2017-07-30,1,Mike Pickerel,1782753.4599999995,North Dakota,New York,2017-07-31
2749,HighMark LLC,CREDIT,397.98,2017-07-30,1,Linda Henderson,1783151.4399999995,Italy,New York,2017-07-31
2750,HighMark LLC,CREDIT,3444.29,2017-07-30,1,Cheryl Trilli,1786595.7299999995,Oregon,New York,2017-07-31
2751,HighMark LLC,CREDIT,957.85,2017-07-30,1,John Ackerman,1787553.5799999996,Montana,New York,2017-07-31
2752,HighMark LLC,CREDIT,3483.57,2017-07-31,1,Mike Pickerel,1791037.1499999997,North Dakota,New York,2017-08-01
1392,HighMark LLC,DEBIT,4794.83,2017-07-31,1,Gwendolyn Morrison,1786242.3199999996,New York,Maryland,2017-08-01
2753,HighMark LLC,CREDIT,2238.26,2017-07-31,1,Linda Henderson,1788480.5799999996,Italy,New York,2017-08-01
2754,HighMark LLC,CREDIT,3015.23,2017-07-31,1,Joanne Fortin,1791495.8099999996,South Carolina,New York,2017-08-01
2755,HighMark LLC,CREDIT,1750.69,2017-07-31,1,Sandy Newkirk,1793246.4999999995,Czech Republic,New York,2017-08-01
2756,HighMark LLC,CREDIT,290.63,2017-07-31,1,Jose Chaves,1793537.1299999994,New Jersey,New York,2017-08-01
2757,HighMark LLC,CREDIT,622.52,2017-07-31,1,Laura Brant,1794159.6499999994,Iowa,New York,2017-08-01
2758,HighMark LLC,CREDIT,658.98,2017-07-31,1,Barbara Hazelrigg,1794818.6299999994,Romania,New York,2017-08-01
2759,HighMark LLC,CREDIT,1001.12,2017-07-31,1,Daniel Walker,1795819.7499999995,South Carolina,New York,2017-08-01
2760,HighMark LLC,CREDIT,3122.14,2017-08-01,1,John Hill,1798941.8899999994,Pennsylvania,New York,2017-08-02
2761,HighMark LLC,CREDIT,577.36,2017-08-01,1,Willie Robinson,1799519.2499999995,South Dakota,New York,2017-08-02
2762,HighMark LLC,CREDIT,1745.87,2017-08-01,1,Malka Cartwright,1801265.1199999996,Alabama,New York,2017-08-02
2763,HighMark LLC,CREDIT,4162.57,2017-08-01,1,Vanessa Carter,1805427.6899999997,Spain,New York,2017-08-02
1404,HighMark LLC,DEBIT,1502.67,2017-08-01,1,Maria Mcgee,1803925.0199999998,New York,Nebraska,2017-08-02
2764,HighMark LLC,CREDIT,355.11,2017-08-01,1,Barbara Bale,1804280.13,Michigan,New York,2017-08-02
2765,HighMark LLC,CREDIT,465.15,2017-08-01,1,Anthony Barnes,1804745.2799999998,Connecticut,New York,2017-08-02
2766,HighMark LLC,CREDIT,3978.83,2017-08-01,1,Christin Walker,1808724.1099999999,Arizona,New York,2017-08-02
2767,HighMark LLC,CREDIT,1387.67,2017-08-01,1,Jose Chaves,1810111.7799999998,New Jersey,New York,2017-08-02
2768,HighMark LLC,CREDIT,1075.92,2017-08-01,1,Agustin Bish,1811187.6999999997,Estonia,New York,2017-08-02
2769,HighMark LLC,CREDIT,702.5,2017-08-01,1,Ronald Mills,1811890.1999999997,Netherlands,New York,2017-08-02
2770,HighMark LLC,CREDIT,1692.51,2017-08-01,1,Susie Major,1813582.7099999997,Kansas,New York,2017-08-02
2771,HighMark LLC,CREDIT,1341.16,2017-08-01,1,Stan Tannenbaum,1814923.8699999996,Rhode Island,New York,2017-08-02
2772,HighMark LLC,CREDIT,589.22,2017-08-02,1,Loren Burgess,1815513.0899999996,Alabama,New York,2017-08-03
2773,HighMark LLC,CREDIT,887.02,2017-08-02,1,Laura Brant,1816400.1099999996,Iowa,New York,2017-08-03
2774,HighMark LLC,CREDIT,725.42,2017-08-02,1,Anthony Smith,1817125.5299999996,Ireland,New York,2017-08-03
2775,HighMark LLC,CREDIT,802.51,2017-08-02,1,John Hill,1817928.0399999996,Pennsylvania,New York,2017-08-03
2776,HighMark LLC,CREDIT,790.81,2017-08-02,1,Cheryl Trilli,1818718.8499999996,Oregon,New York,2017-08-03
2777,HighMark LLC,CREDIT,2408.76,2017-08-02,1,Jason Alves,1821127.6099999996,Wyoming,New York,2017-08-03
2778,HighMark LLC,CREDIT,698.0,2017-08-02,1,Louis Nguyen,1821825.6099999996,Hungary,New York,2017-08-03
2779,HighMark LLC,CREDIT,1944.02,2017-08-02,1,Darius Sherrill,1823769.6299999997,Arkansas,New York,2017-08-03
2780,HighMark LLC,CREDIT,1523.85,2017-08-03,1,Anthony Barnes,1825293.4799999997,Connecticut,New York,2017-08-04
2781,HighMark LLC,CREDIT,1269.8,2017-08-03,1,Osvaldo Porter,1826563.2799999998,Finland,New York,2017-08-04
1423,HighMark LLC,DEBIT,5541.61,2017-08-03,1,Andrew Wolford,1821021.6699999997,New York,North Carolina,2017-08-04
2782,HighMark LLC,CREDIT,1404.14,2017-08-03,1,Danny Singh,1822425.8099999996,Oklahoma,New York,2017-08-04
2783,HighMark LLC,CREDIT,2457.79,2017-08-03,1,Lyle Laskowski,1824883.5999999996,Georgia,New York,2017-08-04
2784,HighMark LLC,CREDIT,1471.06,2017-08-03,1,Ronald Mills,1826354.6599999997,Netherlands,New York,2017-08-04
2785,HighMark LLC,CREDIT,939.0,2017-08-03,1,Antonette Grace,1827293.6599999997,United Kingdom,New York,2017-08-04
2786,HighMark LLC,CREDIT,954.51,2017-08-03,1,Nancy Stutes,1828248.1699999997,Nebraska,New York,2017-08-04
2787,HighMark LLC,CREDIT,1745.77,2017-08-04,1,John Hill,1829993.9399999997,Pennsylvania,New York,2017-08-05
2788,HighMark LLC,CREDIT,5359.89,2017-08-04,1,Cheryl Trilli,1835353.8299999996,Oregon,New York,2017-08-05
2789,HighMark LLC,CREDIT,1439.22,2017-08-04,1,Linda Henderson,1836793.0499999996,Italy,New York,2017-08-05
2790,HighMark LLC,CREDIT,252.8,2017-08-04,1,Angel Hirsch,1837045.8499999996,Pennsylvania,New York,2017-08-05
2791,HighMark LLC,CREDIT,2672.2,2017-08-04,1,Loren Burgess,1839718.0499999996,Alabama,New York,2017-08-05
2792,HighMark LLC,CREDIT,1836.67,2017-08-04,1,Lois Collier,1841554.7199999995,Estonia,New York,2017-08-05
2793,HighMark LLC,CREDIT,670.11,2017-08-04,1,Robert Dugger,1842224.8299999996,Slovenia,New York,2017-08-05
2794,HighMark LLC,CREDIT,891.93,2017-08-04,1,Susan Ware,1843116.7599999995,New York,New York,2017-08-05
2795,HighMark LLC,CREDIT,3597.96,2017-08-04,1,Thomas Read,1846714.7199999995,Arkansas,New York,2017-08-05
2796,HighMark LLC,CREDIT,647.53,2017-08-05,1,Sandy Newkirk,1847362.2499999995,Czech Republic,New York,2017-08-06
2797,HighMark LLC,CREDIT,686.67,2017-08-05,1,Malka Cartwright,1848048.9199999995,Alabama,New York,2017-08-06
1440,HighMark LLC,DEBIT,11045.67,2017-08-05,1,James Moskal,1837003.2499999995,New York,Bulgaria,2017-08-06
2798,HighMark LLC,CREDIT,1142.07,2017-08-05,1,Jennifer Perez,1838145.3199999996,France,New York,2017-08-06
2799,HighMark LLC,CREDIT,359.81,2017-08-05,1,Matthew Ciotti,1838505.1299999997,Hawaii,New York,2017-08-06
2800,HighMark LLC,CREDIT,452.05,2017-08-05,1,James Cole,1838957.1799999997,Wyoming,New York,2017-08-06
2801,HighMark LLC,CREDIT,530.66,2017-08-06,1,Winford Landry,1839487.8399999996,Maine,New York,2017-08-07
2802,HighMark LLC,CREDIT,1564.88,2017-08-06,1,Susan Ware,1841052.7199999995,New York,New York,2017-08-07
2803,HighMark LLC,CREDIT,719.68,2017-08-06,1,Robert Dugger,1841772.3999999994,Slovenia,New York,2017-08-07
2804,HighMark LLC,CREDIT,914.8,2017-08-06,1,Gabriela Hardaway,1842687.1999999995,Italy,New York,2017-08-07
2805,HighMark LLC,CREDIT,1801.04,2017-08-06,1,Linda Henderson,1844488.2399999995,Italy,New York,2017-08-07
2806,HighMark LLC,CREDIT,3165.4,2017-08-06,1,Amy Garland,1847653.6399999994,Slovenia,New York,2017-08-07
2807,HighMark LLC,CREDIT,869.96,2017-08-07,1,Willie Robinson,1848523.5999999994,South Dakota,New York,2017-08-08
2808,HighMark LLC,CREDIT,803.9,2017-08-07,1,Brad Rose,1849327.4999999993,Rhode Island,New York,2017-08-08
2809,HighMark LLC,CREDIT,3172.43,2017-08-07,1,Edna Niese,1852499.9299999992,Virginia,New York,2017-08-08
2810,HighMark LLC,CREDIT,2307.94,2017-08-07,1,Jason Alves,1854807.8699999992,Wyoming,New York,2017-08-08
2811,HighMark LLC,CREDIT,1697.3,2017-08-07,1,Daniel Harrison,1856505.1699999992,Louisiana,New York,2017-08-08
2812,HighMark LLC,CREDIT,361.8,2017-08-07,1,Cheryl Trilli,1856866.9699999993,Oregon,New York,2017-08-08
2813,HighMark LLC,CREDIT,2044.27,2017-08-07,1,Mike Pickerel,1858911.2399999993,North Dakota,New York,2017-08-08
2814,HighMark LLC,CREDIT,1729.05,2017-08-07,1,Gabriela Hardaway,1860640.2899999993,Italy,New York,2017-08-08
2815,HighMark LLC,CREDIT,1990.37,2017-08-07,1,Casey Huffman,1862630.6599999995,Arkansas,New York,2017-08-08
2816,HighMark LLC,CREDIT,2803.97,2017-08-08,1,Mike Pickerel,1865434.6299999994,North Dakota,New York,2017-08-09
2817,HighMark LLC,CREDIT,853.78,2017-08-08,1,Brenda Magnuson,1866288.4099999995,Austria,New York,2017-08-09
2818,HighMark LLC,CREDIT,3390.73,2017-08-08,1,Robert Dugger,1869679.1399999994,Slovenia,New York,2017-08-09
1462,HighMark LLC,DEBIT,1645.75,2017-08-08,1,Alicia Dunn,1868033.3899999994,New York,Tennessee,2017-08-09
2819,HighMark LLC,CREDIT,889.5,2017-08-08,1,Matthew Ciotti,1868922.8899999994,Hawaii,New York,2017-08-09
2820,HighMark LLC,CREDIT,629.49,2017-08-08,1,Juanita Nichell,1869552.3799999994,Indiana,New York,2017-08-09
2821,HighMark LLC,CREDIT,2191.67,2017-08-08,1,Ronald Mills,1871744.0499999993,Netherlands,New York,2017-08-09
